Wog, Wog, Wog, Wog, Wog, Wog, Wog, Wog, Wog, Wog, Wog, Wog, Wog, Wog, Wog, Wog, Wog, Wog, Wog, Wog, Wog, Wog, Wog, Wog, Wog, Wog, Wog, Wog, Wog, Wog, Wog, Wog, Wog, Wog, Wog, Wog, Wog
Wog, Wog, Wog, Wog, Wog, Wog, Wog, Wwg, Wog, Wog, Wog, Wwrt, Wog, Wog, Wog, Wog, Wog, Wog, Wog, Wog, Wog, Wog, Ww^Vm, Wog, Wog, Wog, Wog, Wog, Wog, Wog, Wog, Wog, Wog, Wog, Wog, Wog, Wog
Wog, Wog, Wog, Wog, Ww^Vm, Wog, Wog, Wwg, Wog, Wog, Wog, Wwrt, Wog, Wog, Wog, Wog, Wog, Wog, Wog, Wog, Ww, Ww, Ww, Ww, Ww, Wog, Ww, Wog, Wog, Wog, Wwr, Wog, Wog, Wog, Wog, Wog, Wog
Wog, Wog, Wog, Wog, Wog, Wog, Wog, Wog, Wwrt, Wwrt, Wog, Wog, Ds, Wog, Wog, Wog, Wwr, Wog, Ww, Ww, Ds, Ww, Ds, Ds, Ds, Ww, Wog, Wog, Wwr, Ww, Ww^Vm, Wwr, Wog, Wog, Wog, Wog, Wog
Wog, Wog, Wog, Wog, Wog, Wwg, Wog, Wwrt, Wog, Wog, Wog, Gg, Wog, Ww, Ww, Wog, Wog, Wog, Ww, Ds, Gs^Ftp, Ds, Gg, Gs^Ftp, Ds, Ww, Ww, Cme, Wog, Wog, Wog, Wog, Wog, Wog, Wog, Wog, Wog
Wog, Wog, Wog, Wog, Wwg, Wwg, Wwg, Wog, Gg, Wog, Wog, Wog, Wog, Ww, Ww, Ww^Vm, Wog, Wog, Ww, Ds, Gg, Gs^Ftp, Wog, Wog, Wog, Ww, Wwr, Cme, Cme, Wog, Wog, Wog, Wog, Wog, Wog, Wog, Wog
Wog, Wog, Wog, Wog, Wwg, Ww^Vm, Wwg, Wwg, Wwrt, Wog, Wwrt, Wog, Ww, Ww, Ww, Ww, Ww, Wwr, Wog, Ds, Gg, Wog, Wog, Wog, Wog, Wog, Ww, Wwr, Ww, Cme, Wog, Wog, Wog, Wog, Wog, Wog, Ds
Wog, Wog, Wog, Wog, Wog, Wwg, Wog, Wog, Wwrt, Wwrt, Wog, Wwrt, Ds, Ds, Wog, Ww, Ww, Ww, Wog, Wog, Wog, Wog, Wwr, Wog, Wog, Wog, Wog, Wwr, Cme, Cme, Wwr, Wog, Wog, Wog, Wog, Ds, Ds
Wog, Wog, Cm, Wog, Ww, Wwg, Wog, Wog, Wog, Wog, Ww, Ww, Ww, Ds, Wog, Wog, Ww, Ww, Wog, Wog, Wog, Wwr, Wog, Wog, Gs^Ftp, Wog, Wog, Wog, Wog, Wog, Ww, Wog, Wog, Wog, Wog, Ds, Gg
Wog, Wog, 2 Km, Cm, Wwg, Wog, Wog, Wog, Wog, Gg, Gs^Vh, Ds, Ds, Ds, Wog, Wog, Wog, Gg, Gs^Vh, Ds, Gg, Gg, Wog, Wog, Wog, Wog, Wog, Wog, Wog, Wog, Wog, Wog, Wog, Wog, Ds, Ds, Gg
Wog, Wog, Ww^Vm, Cm, Wwg, Wog, Ww, Wog, Wog, Wog, Ww, Ww, Ds, Wog, Ds, Wog, Wog, Gg, Wog, Wog, Wog, Wog, Wog, Wog, Wog, Wog, Wog, Wog, Gg, Wog, Wog, Wog, Wog, Ds, Gg, Gg, Gg
Wog, Wwrt, Wwrt, Cm, Ww, Ww, Ww, Wwrt, Wog, Wog, Ww, Ds, Ds, Ds, Wog, Wog, Wog, Wog, Wog, Wog, Wog, Wog, Wog, Wog, Wog, Wog, Gg, Gg, Gs^Ft, Ds, Ds, Ds, Ds, Ds, Gs^Ft, Gs^Ft, Gg
Wog, Wog, Wog, Wog, Wog, Ww, Wog, Ww, Wog, Ds, Ds, Ds, Gs, Ww, Ds, Wog, Wog, Wog, Wog, Wog, Wwr, Wwr, Gg, Wog, Ds, Ds, Gg, Gs^Ft, Gs^Ft, Gs^Ft, Gs^Fds, Gs^Ft, Gs^Ft, Gg, Gs^Ftp, Gg, Gg
Wog, Wog, Wog, Wog, Wog, Wog, Wwrt, Wog, Cme, Wog, Cme, Ds, Gs, Ds, Ds, Ds, Gg, Wog, Wog, Wwr, Gs^Ft, Gs^Ft, Gs^Ft, Ds, Gs^Ft, Gs^Ft, Gs^Ft, Gs^Ft, Gs^Fds, Gs^Ft, Gs^Ft, Gs^Ft, Gs^Ft, Gs^Ft, Gs^Ft, Gs^Vh, Gg
Wog, Wog, Wog, Wog, Wwrt, Wog, Wwrt, Wog, Cme, Kme, Cme, Ds, Gg^Efm, Gg, Gg, Gg, Gg, Ds, Ds, Ww, Gs^Ft, Gs^Ft, Gg, Gg, Gg, Gs^Ft, Gg, Gs^Ftp, Gg, Gg, Gs^Ft, Gs^Ft, Gs^Ft, Gs^Ft, Gs^Ft, Gs^Ft, Gg
Wog, Wog, Wog, Wog, Wwrt, Ww^Vm, Ds, Ww, Ww, Cme, Cme, Gg, Gg, Gg^Efm, Gs^Ftp, Gs^Ftp, Gs^Ftp, Ds, Ds, Ds, Gg, Gs^Ft, Gg, Gg, Gs^Ftp, Gs^Ftp, Gs^Ft, Gg, Gs^Ft, Gg, Gs^Ft, Gs^Ft, Gg, Gs^Ft, Ce, Ce, Gg
Wog, Wog, Wog, Wog, Ww, Ds, Gs, Ww, Ds, Wog, Ww, Gg, 1 Gg, Gg, Gg, Gs^Vh, Gs^Ftp, Gs^Ftp, Gg, Gg, Gs^Ftp, Gg, Gs^Ftp, Gs^Ftp, Gs^Ftp, Gs^Ftp, Gs^Ft, Gs^Ft, Gs^Ft, Gs^Ft, Gs^Ft, Gs^Fds, Gs^Ft, Rb, Ce, 3 Ke, Gg
Wog, Wog, Wog, Wog, Ww, Ds, Gs, Gs, Gg, Ww, Gg, Gg, Gg, Gg, Gg^Efm, Gs^Ftp, Gs^Ftp, Gg, Gs^Ftp, Gs^Ftp, Gs^Ftp, Gs^Ftp, Gs^Ftp, Gs^Ftp, Gs^Ftp, Gg, Gs^Ftp, Gs^Fds, Gg^Ve, Gs^Ft, Gs^Fds, Gs^Fds, Gs^Ft, Gg, Rb, Ce, Gg
Wog, Wog, Wog, Ww, Ds, Ds, Gs, Gg, Gg, Gg, Gg, Gg, Gs^Ftp, Gs^Ftp, Gg^Efm, Gs^Ftp, Gs^Ftp, Gs^Ftp, Gs^Ftp, Gg, Gs^Ftp, Gs^Ftp, Gg, Gs^Ftp, Gs^Ft, Gs^Ftp, Gs^Ft, Gs^Ft, Gs^Ft, Gs^Ft, Gs^Ft, Gs^Ft, Gs^Ft, Gs^Ft, Gs^Ft, Rb, Gg
Wog, Wog, Wog, Wwrt, Ww, Ds, Ds, Ww, Gg, Gg, Gg, Gs^Ftp, Gs^Ftp, Gs^Ftp, Gs^Ftp, Gs^Ftp, Gg, Gs^Ftp, Gg, Gg, Gs^Ftp, Gs^Ftp, Gs^Ft, Gs^Fds, Gs^Fds, Gs^Ft, Gs^Ftp, Gs^Ft, Gs^Fds, Gs^Fds, Gs^Ft, Gg, Gs^Ft, Gs^Ft, Gs^Ft, Gs^Ft, Gg
Wog, Wog, Ww^Vm, Wwrt, Wog, Ds, Ww, Ww, Ds, Ds, Gg, Gs^Vh, Gg, Gs^Ftp, Gg, Gg, Gs^Ftp, Gs^Ftp, Gs^Ftp, Gs^Ftp, Gs^Ft, Gs^Ft, Gs^Ft, Gs^Fds, Hh, Gs^Ftp, Hh, Gs^Ft, Gs^Fds, Gs^Ft, Gs^Ft, Gs^Ft, Gs^Ft, Gs^Ft, Gs^Ft, Hh, Gg
Wog, Wog, Wog, Wwrt, Wog, Ww, Ww, Ds, Gg, Gg, Gg, Gg, Gs^Ftp, Gs^Ftp, Gg, Gg, Gg, Gg, Gs^Ftp, Gs^Ftp, Gs^Ft, Gs^Ft, Gs^Ft, Gs^Ft, Gs^Fds, Gs^Ftp, Gs^Ft, Gs^Ft, Gs^Ft, Gg^Ve, Gs^Ft, Gs^Ft, Gs^Ft, Gs^Ft, Hh, Hh, Gs^Ft
Wog, Wog, Wog, Wog, Wwg, Wog, Ds, Ds, Gg, Gg, Gs^Ft, Gs^Ftp, Gs^Ftp, Gs^Ftp, Gs^Ft, Gs^Ft, Gg, Gg, Gg, Gs^Ft, Gs^Ft, Gs^Ft, Gs^Vh, Gs^Ft, Gs^Fds, Ww^Ewf, Gs^Ft, Gs^Ft, Gs^Ft, Ww^Ewl, Gs^Ft, Gs^Ft, Gs^Ft, Gs^Ft, Hh, Gs^Ft, Gs^Ft
Wog, Wog, Wog, Wog, Wwg, Ds, Ds, Ds, Gg, Gg, Gg, Gs^Ftp, Gs^Ftp, Gs^Ft, Gs^Ft, Gg, Gs^Ft, Gs^Ft, Gg, Gs^Ft, Gs^Ftp, Gs^Ft, Gs^Ft, Gs^Ft, Gs^Ft, Gs^Ft, Gs^Ft, Gs^Ft, Gs^Ft, Gs^Ft, Gs^Ftp, Gs^Ftp, Gs^Ft, Gg, Gs^Ft, Gs^Ft, Gs^Ft
Wog, Wog, Wog, Wog, Wog, Wwg, Ds, Ds, Gg, Gg, Gg, Gg, Gs^Ft, Gs^Ftp, Gs^Ftp, Gs^Ftp, Gg, Gs^Ft, Gs^Ftp, Gs^Ftp, Gs^Ftp, Gs^Ft, Gs^Ft, Gs^Ft, Gg^Efm, Gg^Efm, Gs^Fds, Gs^Ft, Gs^Ft, Gs^Ft, Gs^Ftp, Gs^Ftp, Ww^Ewl, Gs^Ft, Gs^Ft, Gs^Ft, Gs^Ft
Wog, Wog, Wog, Wog, Wog, Wog, Ds, Ds, Gg, Gg, Gg, Gg, Gg, Gs^Ftp, Gs^Ftp, Gg, Gs^Ftp, Gs^Ftp, Gs^Ftp, Gs^Ftp, Cv, Gs^Ftp, Gs^Ft, Gs^Ft, Gs^Ft, Gg, Gs^Ft, Gs^Fds, Gs^Ft, Gs^Ft, Ww^Ewf, Gs^Ft, Ww^Ewl, Gs^Ft, Gs^Ft, Gs^Ft, Gg
Wog, Wog, Wwrt, Wog, Wog, Ww, Ww, Ds, Ds, Ds, Gg, Gg, Gs^Efm, Gs^Vh, Gs^Efm, Gg^Efm, Gg, Gs^Ftp, Gs^Ftp, Cv, Kv, Gs^Ft, Gs^Ft, Gs^Ft, Gs^Ft, Gs^Ft, Gs^Ft, Gs^Ft, Gs^Ft, Gs^Ft, Gs^Ft, Ww^Ewl, Gg, Gg, Gs^Ft, Gd^Vo, Gg
Wog, Wog, Wog, Wwrt, Wog, Wog, Ww, Wog, Ds, Ds, Gg, Gs^Ftp, Gg, Gs^Ftp, Gg, Gs^Ftp, Gs^Ft, Gs^Ft, Gs^Ftp, Cv, Gs^Ft, Gs^Ft, Gs^Ft, Gs^Ft, Gs^Ft, Gs^Ft, Gs^Ft, Gs^Ft, Gs^Ft, Gs^Ft, Gs^Ftp, Gs^Ftp, Gs^Ft, Gs^Ft, Gs^Ft, Gs^Ft, Gs^Ft
Wog, Wog, Ww^Vm, Wog, Wog, Wog, Wog, Wog, Ds, Ds, Ds, Gg, Gg, Gg, Gg, Gs^Ft, Gs^Ft, Gs^Ft, Gs^Ft, Gs^Ft, Gg, Gs^Ft, Gs^Ft, Ww^Ewf, Gs^Ft, Gs^Ft, Gg^Ve, Gs^Efm, Gg, Gs^Ft, Gs^Ftp, Gs^Ftp, Hh, Hh, Gs^Ft, Gs^Ft, Gs^Ft
Wog, Wog, Wog, Wog, Wog, Wog, Ds, Wog, Ds, Ds, Ds, Gg, Gg, Gs^Ft, Gs^Ft, Gs^Ft, Gs^Ft, Gs^Ft, Gs^Ft, Gg, Gg, Gg, Ww^Ewf, Ww^Ewl, Ww^Ewl, Gs^Ft, Ww^Ewl, Gs^Efm, Gg, Gg, Gs^Ft, Gs^Ftp, Hh, Gs^Ft, Gs^Ft, Gs^Ft, Gs^Ft
Wog, Wog, Ds, Wog, Ds, Ds, Ds, Ds, Ds, Gg, Gg, Gg, Gs^Ft, Gs^Ft, Gs^Ft, Gs^Ft, Gs^Ft, Gs^Ft, Gs^Ft, Gs^Ft, Gs^Ft, Gs^Ft, Gs^Ft, Gs^Ft, Gs^Ft, Ww^Ewf, Gs^Ft, Gs^Ft, Gg, Gs^Ft, Gs^Ft, Hh, Hh, Gs^Ft, Gs^Ft, Re, Gs^Ft
Ds, Ds, Ds, Ds, Gs^Ft, Gs^Ft, Gs^Ft, Gg, Gg, Gg, Gg, Gs^Ft, Gs^Ft, Gs^Ft, Gs^Ft, Gs^Ft, Gs^Ft, Gs^Ft, Gs^Ft, Gs^Ft, Gs^Ft, Gs^Ft, Gs^Ft, Gs^Ft, Gs^Ft, Gs^Ft, Gs^Ft, Gg, Gg, Gg, Gs^Ft, Gs^Ft, Gs^Ft, Gs^Ft, Gs^Ft, Gs, Gs
Wog, Ds, Gs^Ft, Gs^Ft, Gs^Ft, Gs^Ft, Gs^Ft, Gg, Gs^Ft, Gs^Ft, Gg, Gs^Ft, Gs^Ft, Gs^Ft, Gs^Ft, Gg, Gg, Gg, Gs^Ft, Gs^Ft, Gs^Ft, Gs^Ft, Gg, Gs^Ft, Gg, Gs^Ft, Gs^Ft, Hh, Gg, Gg, Gs^Ft, Gs^Ft, Gs^Ft, Gs^Ft, Gs^Vh, Gs, Re
Gg, Ds, Gs^Ft, Gs^Ft, Gs^Ft, Gs^Ft, Gs^Ft, Hh, Gs^Ft, Gg, Gg, Gg, Gg, Gg, Gs^Ft, Gg, Gs^Ft, Gg, Gg, Gs^Ft, Gg, Gg, Gg, Gg, Gg, Gs^Ft, Gg, Rb, Gg, Gg, Gs, Gs, Gs, Gs, Ce, Re, Re
Gs^Ft, Gg, Gs^Ft, Gs^Ft, Ce, Gs, Ce, Gs^Ft, Gs^Ft, Gg, Gs^Ft, Gs^Ft, Gs^Ft, Gs^Ft, Gs^Ft, Gs^Ft, Gs^Ft, Gg, Gs^Ft, Gg, Gs^Ft, Gs^Ft, Gs^Ft, Gs^Ft, Gs^Ft, Gg, Gs^Ft, Gg, Gs^Ft, Gg, Gg, Gs, Rb, Ce, 5 Ke, Ce, Re
Gs^Ft, Gs^Ft, Gs, Ce, 4 Ke, Ce, Gs, Gs, Gs, Gs^Ft, Gs^Ft, Gs^Ft, Gs^Vh, Gs^Ft, Gs^Ft, Gs^Ft, Gs^Ft, Hh, Gs^Ft, Gs^Ft, Gs^Ft, Gs^Ft, Gs^Vh, Gs^Ft, Gs^Ft, Gs^Ft, Gs^Ft, Gs^Ft, Gs^Ft, Gs^Ft, Re, Re, Re, Ce, Ce, Ce, Re
Gs^Ft, Gs, Gs^Ft, Gs, Gs, Gs, Gs^Ft, Gs, Gs^Ft, Gs^Ft, Gs^Ft, Gs^Ft, Gs^Ft, Gs^Ft, Gs^Ft, Gs^Ft, Gs^Ft, Gs^Ft, Gs^Ft, Gs^Ft, Gs^Ft, Gs^Ft, Gs^Ft, Gs^Ft, Gs^Ft, Gs^Ft, Gs^Ft, Gs^Ft, Gg, Re, Gs^Ft, Re, Gg, Gg, Gg, Re, Gg
