Gll^Fp, Gll^Fp, Gll^Fp, Gll^Fp, Gll^Fp, Gll^Fp, Gll^Fp, Gll^Fp, Gll^Fp, Gll^Fp, Gll^Fp, Gll^Fp, Gll^Fp, Gll^Fp, Gs^Es, Gll, Gll, Gll^Fp, Gll^Fp, Gll^Fp, Gll^Fp, Gll^Fp, Gll^Fp, Gll^Fp, Gll^Fp, Gll^Fp, Gll^Fp, Gll^Fp, Gll^Fp, Gll^Fp, Gll^Fp, Gll^Fp, Gll^Fp, Gll^Fp, Gll^Fp, Gll^Fp
Gll^Fp, Gll^Fp, Gll^Fp, Gll^Fp, Gll^Fp, Gll^Fp, Gll^Fdf, Gll^Fp, Gll^Fp, Gll^Fp, Gll^Fp, Gll^Fp, Gll^Fp, Gll^Fp, Gs^Es, Gll^Es, Gll, Gll^Fp, Gll^Fp, Gll^Fp, Gll^Fp, Gll^Fp, Gll^Fp, Gll^Fp, Gll^Fp, Gll^Fp, Gll^Fp, Gll^Fp, Gll^Fp, Gll^Fp, Gll^Fp, Gll^Fp, Gll^Fp, Gll^Fp, Gs^Em, Gll^Fp
Gll^Fp, Gll^Fp, Gll^Fp, Gll^Fp, Gll^Fp, Gll^Fp, Gll^Fp, Gll^Fp, Gll^Fp, Gll^Fp, Gll^Fp, Gg^Ve, Gll^Fp, Gll^Fp, Gll^Fp, Gs, Gll, Gll, Gll^Fdf, Gll^Fdf, Gll^Fp, Gll^Fp, Gll^Fp, Gll^Fp, Gll^Fp, Gll^Fp, Gll^Fp, Gll^Fp, Gll^Fp, Gll^Fp, Gll^Fp, Gll^Fp, Gll^Fp, Gs^Es, Gll^Es, Gll
Gll^Fp, Gll^Fp, Gll^Fp, Gll^Fp, Gll^Fp, Gll^Fp, Gll^Fp, Gll^Fp, Gll^Fp, Gll^Fp, Gll^Fp, Gll^Fp, Gll^Fp, Gll^Fp, Gll^Fp, Gll^Fp, Gll^Fp, Gll^Es, Gs^Es, Gll^Fp, Gll^Fp, Gll^Fp, Gll^Fp, Gll^Fp, Gll^Fp, Gll^Fp, Gll^Fp, Gg^Fet, Gll^Fp, Gll^Fp, Gll^Fdf, Gll^Fp, Gs^Em, Gs^Es, Gll^Fp, Gs
Gll^Fp, Gll^Fp, Gll^Fp, Gll^Fp, Gll^Fp, Gll^Fp, Gll^Fp, Gll^Fp, Gll^Fp, Gll^Fp, Gll^Fp, Gll^Fp, Gll^Fp, Gll^Fp, Gll^Fp, Gll^Fp, Gll^Fp, Gll^Es, Gs, Gll^Fp, Gll^Fdf, Gll^Fdf, Gs^Em, Gs^Emf, Gll^Es, Gll^Fp, Gll^Fp, Gll^Fp, Gll^Fp, Gll^Fp, Gll^Em, Gll, Gll^Fp, Gll^Fp, Gll^Fp, Gll^Fp
Gll^Fp, Gll^Fp, Gg^Ve, Gll^Fp, Gll^Fp, Gll^Fp, Gll^Fp, Gll^Fdf, Gll^Fp, Gll^Fp, Gll^Fp, Gll^Fp, Gll^Fp, Gll^Fp, Gll^Fp, Gll^Fp, Gs^Emf, Gd, Gd, Gs^Em, Gll^Fp, Gll^Fp, Gll, Gs, Gs, Gll^Fp, Gg^Ve, Gll^Fp, Gll^Es, Gs, Gs, Gll^Fp, Gll^Fp, Gll^Fp, Gll^Fp, Gll^Fp
Gll^Fp, Gll^Fp, Gll^Fp, Gll^Fp, Gll^Fp, Gll^Fp, Gll^Fp, Gll^Fp, Gg^Fet, Gll^Fp, Gll^Fp, Gll^Fp, Gll^Fp, Gll^Fdf, Gll^Fp, Gll^Fp, Gs^Es, Gd^Es, Gd, Gs, Gll, Gll^Es, Gll^Fp, Gll, Gll^Fp, Gs^Em, Gs, Gll^Es, Gll, Gs^Emf, Gll^Fp, Gll^Fp, Gll^Fp, Gll^Fp, Gll^Fp, Gll^Fp
Gll^Fp, Gll^Fp, Gll^Fp, Gll^Fp, Gs^Es, Gll^Fp, Gll^Fp, Gll^Fp, Gll^Fp, Gll^Fp, Gll^Fp, Gll^Fp, Gll^Fp, Gll^Fp, Gll^Fp, Gll^Fp, Gll^Fp, Gs^Es, Gd^Em, Gd, Gll^Fp, Gll^Fp, Gll^Fdf, Gll^Fp, Gll^Fp, Gs^Emf, Gll^Fp, Gll^Fp, Gll^Fp, Gll^Emf, Gll^Fp, Gll^Fp, Gll^Fp, Gll^Fdf, Gll^Fp, Gll^Fp
Gll^Fp, Gll^Fp, Gll^Fp, Gs^Es, Gs^Em, Gll, Gll, Gs^Emf, Gs^Es, Gll^Fp, Gll^Fdf, Gll^Fp, Gll^Fp, Gll^Fp, Gll^Fp, Gg^Ve, Gll^Fp, Gd, Gd, Gll^Fp, Gll^Fp, Gll^Fp, Gll^Fp, Gll^Fp, Gll^Fp, Gll^Fdf, Gll^Fp, Gll^Fp, Gll^Fp, Gg^Fet, Gll^Fp, Gll^Fp, Gll^Fp, Gll^Fp, Gll^Fp, Gll^Fp
Gs, Gll^Fp, Gll, Gll, Gll^Fp, Gll^Fdf, Gll^Fp, Gll^Em, Gs, Gll^Fp, Gll^Fp, Gll^Fp, Gs^Emf, Gs^Emf, Gll^Fp, Gll^Fp, Gd, Gd, Gll^Es, Gll^Fp, Gll^Fp, Gll^Fp, Gll^Fp, Gll^Fp, Gll^Fp, Gll^Fp, Gll^Fp, Gll^Fp, Gll^Fp, Gll^Fp, Gll^Fp, Gll^Fp, Gll^Fp, Gll^Fp, Gll^Fp, Gll^Fp
Gs^Em, Gs^Es, Gll^Fp, Gll^Fdf, Gll^Fp, Gll^Fp, Gll^Fp, Gll^Fp, Gll^Fp, Gs^Es, Gll, Gll^Fp, Gs, Gll, Gll, Gll, Gll^Fp, Gd^Es, Gll^Fdf, Gll^Em, Gll^Fp, Gll^Fp, Gll^Fp, Gg^Ve, Gll^Fp, Gll^Fp, Gll^Fp, Gll^Fp, Gll^Fdf, Gll^Fp, Gll^Fp, Gll^Fp, Gll^Fp, Gll^Fp, Gll^Fp, Gll^Fp
Gll^Fp, Gll^Fp, Gll^Fp, Gll^Fp, Gll^Fp, Gll^Fp, Gll^Fp, Gll^Fp, Gll^Fp, Gll^Fp, Gll^Fp, Gs, Gll^Fdf, Gll^Em, Gll^Fp, Gs^Em, Gs^Em, Gs, Gll^Es, Gll, Gll^Fp, Gll^Fp, Gll^Fdf, Gll^Fp, Gll^Fp, Gll^Fp, Gll^Fp, Gll^Fp, Gll^Fp, Gll^Fp, Gll^Fp, Gll^Fp, Gll^Fp, Gg^Ve, Gll^Fp, Gll^Fp
Gll^Fp, Gll^Fp, Gll^Fp, Gll^Fp, Gll^Fp, Gll^Fp, Gll^Fp, Gg^Fet, Gll^Fp, Gll^Fp, Gll^Fp, Gll^Fp, Gll^Fp, Gll^Fp, Gll^Fp, Gll^Fp, Gll^Fp, Gll^Fp, Gll^Es, Gs, Gll^Fp, Gll^Fp, Gll^Fp, Gll^Fp, Gll^Fp, Gll^Fp, Gll^Fp, Gll^Fp, Gll^Fp, Gll^Fp, Gll^Fp, Gll^Fp, Gll^Fp, Gll^Fp, Gll^Fp, Gll^Fp
Gll^Fp, Gll^Fp, Gll^Fp, Gll^Fp, Gll^Fp, Gll^Fp, Gll^Fdf, Gll^Fp, Gll^Fp, Gll^Fp, Gll^Fp, Gll^Fp, Gll^Fp, Gll^Fp, Gll^Fp, Gll^Fp, Gll^Fp, Gll^Fp, Gs, Gs, Gll^Fp, Gll^Fp, Gll^Fp, Gll^Fp, Gll^Fp, Gll^Fp, Gg^Ve, Gll^Fp, Gll^Fp, Gll^Fdf, Gll^Fp, Gll^Fp, Gll^Fp, Gll^Fp, Gll^Fp, Gll^Fp
Gll^Fp, Gll^Fp, Gll^Fp, Gll^Fp, Gll^Fp, Gll^Fp, Gll^Fp, Gll^Fp, Gll^Fp, Gll^Fp, Gll^Fp, Gll^Fp, Gll^Fp, Gll^Fp, Gll^Fp, Gll^Fp, Gll^Fp, Gll^Fp, Gs^Es, Gll, Gll^Fp, Gll^Fp, Gll^Fp, Gll^Fp, Gll^Fp, Gll^Fp, Gll^Fp, Gll^Fp, Gll^Fp, Gll^Fp, Gll^Fp, Gll^Fp, Gll^Fp, Gll^Fp, Gll^Fp, Gll^Fp
Gll^Fp, Gll^Fp, Gll^Fp, Gll^Fp, Gll^Fp, Gll^Fp, Gll^Fp, Gll^Fp, Gll^Fp, Gll^Fp, Gll^Fp, Gll^Fp, Gll^Fp, Gll^Fp, Gll^Fp, Gll^Fp, Gg^Ve, Gll^Fp, Gll^Es, Gll^Es, Gll^Fp, Gll^Fp, Gll^Fp, Gll^Fp, Gll^Fp, Gll^Fp, Gll^Fp, Gll^Fp, Gll^Fp, Gll^Fp, Gg^Ve, Gll^Fp, Gll^Fp, Gll^Fp, Gll^Fp, Gll^Fp
Gll^Fp, Gll^Fp, Gll^Fp, Gll^Fp, Gg^Ve, Gll^Fp, Gll^Fp, Gll^Fp, Gll^Fp, Gll^Fp, Gll^Fp, Gll^Fp, Gg^Ve, Gll^Fp, Gll^Fp, Gll^Fp, Gll, Gll, Gs, Gs, Gll^Fp, Gll^Fp, Gll^Fp, Gll^Fp, Gll^Fp, Gll^Fp, Gll^Fp, Gll^Fp, Gll^Fp, Gll^Fp, Gll^Fp, Gll^Fp, Gll^Fp, Gll^Fp, Gg^Fet, Gll^Fp
Gll^Fp, Gll^Fp, Gll^Fp, Gll^Fp, Gll^Fp, Gll^Fp, Gll^Fp, Gll^Fp, Gg^Efm, Gll^Fp, Gll^Fp, Gll^Fp, Gll^Fp, Gll^Fp, Gll^Fp, Gll, Cv, Cv, Cv, Gs^Es, Gll^Fp, Gg^Ve, Gll^Fp, Gll^Fp, Gll^Fp, Gll^Fp, Gg^Ve, Gll^Fp, Gll^Fp, Gll^Fp, Gll^Fp, Gll^Fp, Gll^Fp, Gll^Fp, Gll^Fp, Gll^Fp
Gll^Fp, Gll^Fp, Gll^Fp, Gll^Fp, Gll^Fp, Gg^Ve, Gll^Fp, Gs^Efm, Gg, Gll^Fp, Gg^Ve, Gll^Fp, Gll^Fp, Gll^Fp, Cv, Cv, Gs, Gs^Efm, Gs^Efm, Cv, Cv, Gll^Fp, Gll^Fp, Gll^Fp, Gll^Fp, Gll^Fp, Gs^Efm, Gg^Efm, Gll^Fp, Gll^Fp, Gll^Fp, Gll^Fp, Gll^Fp, Gll^Fp, Gll^Fp, Gll^Fp
Gll^Fp, Gll^Fp, Gll^Fp, Gll^Fp, Gll^Fp, Gll^Fp, Gll^Fp, Gs^Em, Wwg, Wwg, Gll^Fp, Gll^Fp, Xuf, Cv, Gg^Fp, Gg^Fp, Ww^Ewf, Ww^Ewf, Ww^Ewf, Gg^Fp, Gg^Fp, Cv, Xuf, Gll^Fp, Gg^Ve, Wwg, Wwg, Gs^Em, Gll^Fp, Gll^Fp, Gll^Fp, Gll^Fp, Gll^Fp, Gll^Fp, Gll^Fp, Gll^Fp
Gll^Fp, Gll^Fp, Gll^Fp, Gll^Fp, Gll^Fp, Gll^Fp, Gll^Fp, Gll^Fp, Gll^Fp, Wwf, Gg^Fet, Gg^Efm, Xuf, Cv^Fp, Gg^Fp, Gs^Efm, Ww^Ewf, Gs^Fet, Ww^Ewf, Gg^Fp, Gg^Fp, Cv^Fp, Xuf, Gs, Gg^Fet, Wwf, Gll^Fp, Gll^Fp, Gll^Fp, Gll^Fp, Gll^Fp, Gll^Fp, Gll^Fp, Gg^Ve, Gll^Fp, Gll^Fp
Gll^Fp, Gll^Fp, Gll^Fp, Gll^Fp, Gg^Ve, Gll^Fp, Gll^Fp, Gg^Ve, Gll^Fp, Gs^Em, Gs^Efm, Gs^Efm, Xuf, Cv^Fp, Gg^Fp, Gs^Efm, Ww^Ewf, Gg^Ve, Ww^Ewf, Gs^Efm, Gg^Fp, Cv^Fp, Xuf, Gg^Em, Gg^Efm, Gs^Efm, Xuf, Gll^Fp, Gll^Fp, Gg^Ve, Gll^Fp, Gll^Fp, Gll^Fp, Gll^Fp, Gll^Fp, Gll^Fp
Gll^Fp, Gll^Fp, Gll^Fp, Gll^Fp, Xuf, Gll^Fp, Gll^Fp, Gll^Fp, Xuf, Xuf, Xuf, Xuf, Xuf, Cv^Fet, Cv^Fp, Gg^Fp, Gs, Ww^Ewf, Gs^Efm, Gg^Fp, Cv^Fp, Cv^Fet, Xuf, Xuf, Xuf, Xuf, Cv, Cv, Cv, Gll^Fp, Xuf, Xuf, Gg^Ve, Gll^Fp, Gll^Fp, Gll^Fp
Gll^Fp, Gg^Ve, Gll^Fp, Gll^Fp, Xuf, Xuf, Cv, Cv, Cv, Cv, Cv, Cv^Fms, Cv^Fet, Xuf, Xuf, Cv, Cv, Gs^Efm, Cv, Cv, Xuf, Xuf, Cv^Fet, Cv^Fms, Cv, Cv, Gg^Fp, Gg^Fp, Gg^Fp, Cv^Fms, Cv^Fet, Xuf, Gll^Fp, Gll^Fp, Gll^Fp, Gll^Fp
Xuf, Gll^Fp, Gll^Fp, Gll^Fp, Cv, Xuf, Cv, Cv, Gg^Fp, Gg^Fp, Gs^Efm, Cv^Fms, Cv^Fp, Cv^Fp, Xuf, Xuf, Cv, Cv, Cv, Xuf, Xuf, Cv^Fp, Cv^Fp, Cv^Fms, Gg^Fp, Gg^Fp, Ww^Ewl, Gs^Em, Gs^Efm, Gg^Fp, Cv^Fms, Cv^Fp, Cv, Gll^Fp, Xuf, Xuf
Xuf, Xuf, Cv, Cv, Cv^Fp, Cv^Fp, Cv, Gs^Efm, Ww^Ewl, Ww^Ewl, Ww^Ewf, Gs, Gll^Efm, Cv, Cv, Xuf, Cv^Fms, Cv^Fp, Cv^Fp, Xuf, Cv, Cv, Gg^Fp, Gs^Efm, Gs^Efm, Ww^Ewl, Gs^Fet, Ww^Ewl, Gg^Ve, Gg^Fp, Cv^Fp, Cv, Gs^Em, Cv, Xuf, Xuf
Xuf, Xuf, Cv, Cv, Gs^Em, Cv^Fms, Cv, Gs, Ww^Ewf, Gs^Fet, Gg^Fp, Gg^Fp, Cv, Gs^Efm, Gs, Cv, Cv^Fp, Cv^Fet, Cv^Fms, Cv, Gg^Fp, Gs, Gll^Efm, Gg^Fp, Gg^Ve, Ww^Ewf, Ww^Ewl, Ww^Ewf, Cv, Cv^Fms, Cv^Fet, Cv, Cv^Fp, Gg^Fp, Cv, Xuf
Xuf, Cv, Gg^Fp, Gs, Cv^Fp, Cv, Gg^Ve, Gg^Fp, Gg^Fp, Gg^Fp, Cv, Gg^Ve, Kv, Cv, Cv, Gg^Fp, Gs, Cv^Fds, Cv, Gg^Fp, Gg^Fp, Gs, Cv^Fp, Cv, Cv, Gg^Fp, Gg^Fp, Gg^Fp, Cv^Fp, Kv, Kv, Kv, Cv^Fms, Gg^Fp, Cv, Xuf
Xuf, Cv, Gg^Fp, Cv, Gg^Ve, Kv, Cv^Fms, Cv^Fet, Gg^Fp, Gg^Fp, Cv, Kv, Cv^Fet, Kv, Cv, Gs^Efm, Gg^Fet, Cv, Cv, Gg^Fet, Gs^Efm, Cv^Fms, Kv, Kv, Kv, Gg^Ve, Gs^Efm, Gs^Efm, Cv^Fet, Cv^Fms, Kv, Cv, Gg^Ve, Gs^Em, Cv, Xuf
Xuf, Cv, Gs^Em, Cv, Kv, Kv, Kv, Gg^Ve, Gg^Fp, Gg^Efm, Gg^Fp, Cv^Fms, Cv^Fms, Gg^Ve, Gg^Fp, Gg^Fp, Gg^Fp, Cv^Fp, Cv^Fp, Gs^Efm, Gg^Fp, Cv, Gg^Ve, Cv^Fet, Cv^Fms, Cv, Gll^Efm, Gs, Gg^Fp, Gg^Ve, Cv, Cv, Gg^Fp, Gs, Cv, Xuf
Xuf, Cv, Cv, Gs, Gg^Fp, Cv, Cv, Gs, Gs^Efm, Gg^Fp, Gg^Fp, Gg^Fp, Gll^Efm, Gg^Fp, Gs, Gs^Efm, Cv, Cv^Fp, Kv^Fet, Cv, Cv, Gg^Fp, Gs, Cv^Fp, Gg^Fp, Gg^Fp, Ww^Ewf, Ww^Ewl, Ww^Ewl, Gg^Fp, Cv^Fp, Cv, Cv^Fms, Cv, Xuf, Xuf
Xuf, Xuf, Cv, Cv, Cv, Cv^Fms, Cv^Fp, Gg^Fp, Ww^Ewl, Ww^Ewf, Ww^Ewl, Gs^Efm, Gs, Gg^Fp, Cv^Fp, Cv, Cv, Cv, Cv^Fp, Cv^Fp, Cv^Fp, Cv^Fp, Cv, Gs^Efm, Gg^Fp, Ww^Ewf, Ww^Ewl, Gs^Fet, Ww^Ewl, Gs^Efm, Cv^Fms, Cv^Fet, Cv^Fp, Cv, Xuf, Xuf
Xuf, Xuf, Gs^Em, Cv, Cv^Fp, Cv^Fet, Cv, Gg^Fp, Gg^Fp, Gs^Fet, Gg^Fp, Gs, Cv, Cv^Fp, Cv^Fp, Cv, Gg^Fp, Gg^Fp, Gs^Efm, Gs, Gg^Fp, Cv^Fp, Cv, Cv, Cv, Gs^Efm, Gs, Ww^Ewl, Cv, Cv, Cv, Cv, Gll^Fp, Gs^Em, Gs^Emf, Xuf
Gll^Fp, Gll^Fp, Gll^Fp, Gs^Em, Gll^Fp, Cv^Fms, Cv, Cv, Cv, Gg^Fp, Cv^Fds, Cv, Cv, Cv^Fp, Gg^Fp, Gg^Fp, Gg^Fet, Gg^Fp, Ww^Ewl, Gg^Fet, Gg^Fet, Gg^Fp, Gg^Fp, Cv, Cv, Cv^Fds, Cv^Fet, Cv^Fp, Xuf, Xuf, Gll^Fp, Gll^Fp, Gll^Fp, Gll^Fp, Gll^Fp, Gll^Fp
Gll^Fp, Gll^Fp, Gg^Ve, Gll^Fp, Gll^Efm, Gll^Fp, Xuf, Xuf, Xuf, Cv^Fp, Cv^Fet, Cv^Fds, Gs, Gs^Efm, Gs, Gg^Fet, Gll^Emf, Ww^Ewl, Ww^Ewl, Gll^Emf, Gg^Fet, Gs^Efm, Gs, Gg^Fp, Cv, Cv^Fms, Cv^Fp, Cv^Fms, Xuf, Xuf, Gll^Fp, Gll^Fp, Gg^Ve, Gll^Efm, Gll^Fp, Gll^Fp
Gll^Fp, Gll^Fp, Gll^Fp, Gll^Fp, Gll^Fp, Gs^Emf, Gll^Fp, Xuf, Xuf, Cv^Fms, Cv^Fms, Cv^Fp, Cv, Gs^Efm, Gg^Fp, Gg^Fet, Gg^Fet, Ww^Ewf, Gg^Fp, Gg^Fet, Gll^Efm, Gg^Fp, Cv, Cv, Xuf, Xuf, Xuf, Xuf, Gll^Fp, Gll^Fp, Gg^Ve, Gll^Fp, Gll^Fp, Gll^Fp, Gll^Fp, Gll^Fp
Gll^Fp, Gll^Fp, Gll^Fp, Gll^Fp, Gll^Fp, Gll^Fp, Gg^Ve, Gll^Fp, Gll^Fp, Xuf, Xuf, Xuf, Cv, Cv^Fp, Cv^Fp, Gg^Fp, Gg^Fp, Gg^Fp, Gs^Efm, Gg^Fp, Cv^Fp, Cv^Fp, Cv^Fp, Cv, Gll^Fp, Xuf, Gll^Fp, Gll^Fp, Gll^Fp, Gll^Efm, Gll^Fp, Gll^Fp, Gll^Fmf, Gll^Efm, Gll^Fp, Gll^Fp
Gll^Fp, Gll^Fp, Gll^Fp, Gll^Fp, Gll^Fdf, Gll^Fp, Gll^Fp, Gll^Efm, Gll^Efm, Gll^Fp, Gs^Emf, Xuf, Gll^Fp, Cv^Fp, Cv^Fp, Cv^Efm, Cv, Gg^Fp, Cv, Cv, Cv^Fp, Cv^Fp, Gll^Fp, Gll^Fp, Gll^Efm, Gll^Fp, Gg^Ve, Gll^Fp, Gll^Fp, Gll^Fp, Gll^Fp, Gll^Fmf, Gll^Fp, Gll^Fp, Gll^Fp, Gll^Fp
Gll^Fp, Gll^Fp, Gll^Fp, Gll^Fp, Gll^Fp, Gll^Fp, Gll^Fp, Gll^Efm, Gll^Fp, Gll^Fp, Gg^Ve, Gll^Fp, Gll^Fp, Gll^Fp, Xuf, Xuf, Xuf, Cv, Cv, Cv^Fp, Gll^Fp, Gll^Fp, Gll^Fp, Gll^Fp, Gll^Fp, Gll^Fp, Gll^Fp, Gll^Fp, Gll^Fp, Gll^Efm, Gll^Fmf, Gll^Fmf, Gll^Efm, Gll^Fp, Gll^Fp, Gll^Fp
Gll^Fp, Gll^Efm, Gll^Fp, Gll^Fp, Gll^Fp, Gll^Fp, Gll^Efm, Gll^Fp, Gll^Fdf, Gll^Fp, Gll^Efm, Gll^Fp, Gll^Efm, Gll^Fp, Gll^Fp, Xuf, Xuf, Cv, Gs^Es, Gs, Gll^Fp, Gll^Fp, Gll^Efm, Gg^Ve, Gll^Fp, Gll^Fp, Gll^Efm, Gll^Fp, Gll^Fp, Gll^Fmf, Gll^Fmf, Gll^Fp, Gll^Fp, Gll^Fp, Gll^Fp, Gll^Efm
Gll^Fp, Gll^Fp, Gll^Fp, Gg^Ve, Gll^Fp, Gll^Fp, Gll^Fp, Gll^Fp, Gll^Fp, Gll^Fp, Gll^Efm, Gll^Fp, Gll^Fp, Gg^Ve, Gll^Fp, Gll^Fp, Gll^Fp, Gll^Fp, Gll^Efm, Gs, Gg^Ve, Gll^Fp, Gll^Fp, Gll^Fp, Gll^Fmf, Gll^Fp, Gll^Fdf, Gll^Fdf, Gll^Fdf, Gll^Fdf, Gll^Fp, Gll^Fp, Gg^Ve, Gll^Fp, Gll^Fp, Gll^Fp
Gll^Fp, Gll^Fp, Gll^Fp, Gll^Fp, Gll^Fdf, Gll^Fp, Gll^Fp, Gll^Fp, Gll^Fp, Gll^Fp, Gll^Fp, Gll^Fp, Gll^Fp, Gll^Fp, Gll^Fdf, Gll^Efm, Gll^Fp, Gll^Efm, Gll^Em, Gll, Gll^Efm, Gll^Fp, Gll^Fp, Gll^Fp, Gll^Fp, Gll^Fdf, Gll^Fp, Gll^Fp, Gll^Fp, Gll^Fp, Gll^Fp, Gll^Fp, Gll^Fp, Gll^Fp, Gll^Fp, Gll^Fp
Gll^Fp, Gll^Fp, Gll^Fdf, Gll^Fp, Gll^Fp, Gll^Fp, Gll^Fp, Gll^Fp, Gg^Ve, Gll^Fp, Gll^Fp, Gll^Fdf, Gll^Fp, Gll^Fp, Gll^Fp, Gll^Fp, Gll^Fp, Gll^Fp, Gs, Gll, Gll^Fp, Gll^Fp, Gll^Fp, Gll^Fp, Gll^Fp, Gll^Fp, Gll^Fp, Gll^Fp, Gll^Fp, Gg^Ve, Gll^Fp, Gll^Fp, Gll^Fp, Gll^Fp, Gll^Fp, Gll^Fp
Gll^Fp, Gll^Fp, Gll^Fp, Gll^Fp, Gll^Fp, Gll^Fp, Gll^Fp, Gll^Fdf, Gll^Fp, Gll^Fdf, Gll^Fp, Gll^Fp, Gll^Fdf, Gll^Fp, Gll^Fdf, Gll^Fp, Gll^Fp, Gll^Fp, Gll, Gs, Gll^Fp, Gll^Fp, Gll^Fp, Gll^Fp, Gg^Ve, Gll^Fp, Gll^Fp, Gll^Fp, Gll^Fp, Gll^Fp, Gll^Fp, Gll^Fmf, Gll^Fmf, Gll^Fmf, Gll^Fp, Gll^Fp
Gll^Fp, Gll^Fp, Gll^Fp, Gll^Fp, Gll^Fp, Gll^Fp, Gll^Fp, Gll^Fp, Gll^Fp, Gll^Fp, Gll^Fp, Gll^Fp, Gll^Fp, Gll^Fp, Gll^Fp, Gll^Fp, Gg^Ve, Gll^Fp, Gd, Gs^Es, Gll^Fp, Gll^Fp, Gll^Fp, Gll^Fp, Gll^Fp, Gll^Es, Gll^Fp, Gll^Fp, Gll^Fp, Gll^Fp, Gll^Fp, Gll^Fp, Gll^Fmf, Gll^Fp, Gll^Fp, Gll^Fp
Gll^Fp, Gll^Fp, Gll^Fp, Gll^Fp, Gll^Fp, Gll^Fp, Gll^Fp, Gll^Fp, Gll^Fp, Gll^Fp, Gll^Es, Gll^Fp, Gll^Fp, Gll^Fp, Gll^Fp, Gll^Fp, Gll^Fp, Gll^Fp, Gd, Gd^Es, Gll^Fp, Gll^Fp, Gll^Fp, Gll^Fp, Gs^Es, Gs^Efm, Gll^Fp, Gll^Fp, Gll^Fdf, Gll^Fp, Gll^Fp, Gll^Fp, Gll^Fp, Gll^Fp, Gs^Es, Gs
Gll^Fp, Gll^Fp, Gll^Fp, Gll^Fp, Gg^Ve, Gll^Fp, Gll^Fp, Gll^Fp, Gll^Fp, Gll, Gll^Fdf, Gs, Gs^Em, Gs^Es, Gll^Es, Gll^Fp, Gs^Em, Gd^Es, Gd, Gs, Gll^Fp, Gll^Fp, Gll, Gll^Es, Gll, Gll, Gll^Es, Gll^Fp, Gll^Fp, Gll^Fp, Gll^Fp, Gg^Ve, Gs^Efm, Gll^Es, Gll^Fp, Gll
Gll^Fp, Gll^Fp, Gll^Fp, Gll^Fp, Gll^Fp, Gll^Fp, Gll^Fp, Gll^Fmf, Gll^Fp, Gs, Gll^Em, Gll, Gll^Fp, Gll^Fp, Gll^Fp, Gll, Gs, Gs, Gd, Gs, Gs^Em, Gll^Em, Gll^Fp, Gll^Fp, Gll^Fp, Gll^Fp, Gll^Fp, Gs, Gs^Efm, Gll, Gll^Em, Gs^Efm, Gll^Fp, Gll^Fdf, Gll^Fp, Gll^Fp
Gll^Fp, Gll^Fp, Gll^Fmf, Gll^Fp, Gll^Fdf, Gll^Fp, Gll, Gll^Fp, Gs^Es, Gs^Es, Gll^Fp, Gll^Fp, Gg^Ve, Gll^Fp, Gll^Fp, Gll^Fp, Gll^Fp, Gll^Fp, Gd^Em, Gd, Gs, Gll^Fp, Gg^Ve, Gll^Fp, Gll^Fp, Gll^Fp, Gll^Fp, Gll^Fp, Gll^Fp, Gll^Es, Gll^Emf, Gll^Fmf, Gll^Fp, Gll^Fp, Gll^Fp, Gll^Fp
Gll^Fp, Gll^Fp, Gll, Gll, Gs^Es, Gll^Es, Gll, Gll, Gll^Fp, Gll^Fp, Gll^Fp, Gll^Fp, Gll^Fp, Gll^Fp, Gll^Fp, Gll^Fmf, Gll^Fp, Gll^Fp, Gd^Es, Gs, Gll^Fp, Gll^Fp, Gll^Fp, Gll^Fp, Gll^Fp, Gll^Fp, Gll^Fp, Gg^Ve, Gll^Fp, Gll^Fdf, Gll^Fp, Gll^Fp, Gll^Fp, Gll^Fp, Gll^Fp, Gll^Fp
Gs, Gs^Em, Gll^Fdf, Gll, Gs^Em, Gs, Gll^Fp, Gll^Fp, Gg^Ve, Gll^Fp, Gll^Fp, Gll^Fp, Gll^Fp, Gll^Fmf, Gll^Fp, Gll^Fdf, Gll^Fp, Gll^Fp, Gs, Gll, Gll^Fp, Gll^Fp, Gll^Fp, Gll^Fp, Gll^Fp, Gll^Fp, Gll^Fp, Gll^Fp, Gll^Fp, Gll^Fp, Gll^Fp, Gll^Fp, Gll^Fp, Gg^Ve, Gll^Fp, Gll^Fp
Gs^Es, Gll^Es, Gll^Fp, Gll^Fp, Gll^Fp, Gll^Fdf, Gll^Fp, Gll^Fp, Gll^Fp, Gll^Fp, Gll^Fp, Gll^Fp, Gll^Fp, Gll^Fp, Gll^Fp, Gll^Fmf, Gll^Fp, Gll^Fp, Gs, Gll^Es, Gll^Fp, Gll^Fp, Gll^Fp, Gll^Fp, Gll^Fp, Gll^Fp, Gll^Fp, Gll^Fp, Gll^Fp, Gll^Fp, Gll^Fp, Gll^Fmf, Gll^Fp, Gll^Fp, Gll^Fmf, Gll^Fp
Gll^Fp, Gll^Fp, Gll^Fp, Gll^Fp, Gll^Fp, Gll^Fp, Gll^Fp, Gll^Fp, Gll^Fp, Gll^Fp, Gll^Fdf, Gll^Fp, Gll^Fp, Gll^Fp, Gll^Fp, Gll^Fp, Gll^Fp, Gll^Fp, Gll, Gll, Gll^Fp, Gll^Fdf, Gll^Fp, Gll^Fp, Gll^Fp, Gll^Fp, Gll^Fp, Gll^Fp, Gll^Fp, Gg^Ve, Gll^Fp, Gll^Fp, Gll^Fp, Gll^Fp, Gll^Fp, Gll^Fp
Gll^Fp, Gll^Fp, Gll^Fp, Gg^Ve, Gll^Fp, Gll^Fp, Gll^Fp, Gll^Fp, Gll^Fp, Gll^Fp, Gll^Fp, Gll^Fp, Gll^Fp, Gg^Ve, Gll^Fp, Gll^Fp, Gll^Fp, Gll^Fp, Gll^Es, Gll^Em, Gll^Fp, Gll^Fp, Gll^Fp, Gll^Fp, Gg^Ve, Gll^Fp, Gll^Fp, Gll^Fp, Gll^Fp, Gll^Fp, Gll^Fmf, Gll^Fdf, Gll^Fp, Gll^Fdf, Gll^Fp, Gll^Fp
Gll^Fp, Gll^Fp, Gll^Fp, Gll^Fp, Gll^Fdf, Gll^Fp, Gll^Fp, Gll^Fp, Gll^Fdf, Gll^Fp, Gll^Fp, Gll^Fp, Gll^Fp, Gll^Fp, Gll^Fp, Gll^Fp, Gll^Fp, Gll^Fp, Gs^Es, Gs, Gll^Fp, Gll^Fp, Gll^Fp, Gll^Fp, Gll^Fp, Gll^Fp, Gll^Fp, Gll^Fp, Gll^Fp, Gll^Fp, Gll^Fp, Gll^Fp, Gll^Fp, Gll^Fp, Gll^Fp, Gll^Fp
Gll^Fp, Gll^Fp, Gll^Fp, Gll^Fp, Gll^Fp, Gll^Fp, Gll^Fp, Gll^Fp, Gll^Fp, Gll^Fp, Gll^Fp, Gll^Fp, Gll^Fp, Gll^Fp, Gll^Fp, Gll^Fp, Gll^Fp, Gll^Fp, Gs, Gs, Gll, Gll^Fp, Gll^Fp, Gll^Fp, Gll^Fp, Gll^Fp, Gll^Fp, Gll^Fp, Gll^Fp, Gll^Fp, Gll^Fp, Gll^Fp, Gll^Fp, Gll^Fp, Gll^Fp, Gll^Fp
