Gll^Fp, Gll^Fp, Gll^Fp, Gll^Fp, Gll^Fp, Gll^Fp, Gll^Fp, Gll^Fp, Gll^Fp, Gll^Fp, Gll^Fp, Gll^Fp, Gll^Fp, Gll^Fp, Isa, Gll^Fp, Isa, Gll^Fp, Gll^Fp, Gll^Fp, Gll^Fp, Gll^Fp, Gll^Fp, Gll^Fp, Gll^Fp, Gll^Fp, Gll^Fp, Gll^Fp, Gll^Fp, Gll^Fp, Gll^Fp, Gll^Fp, Gll^Fp, Gll^Fp, Gll^Fp, Gll^Fp
Gll^Fp, Gll^Fp, Gll^Fp, Gll^Fp, Gll^Fp, Gll^Fp, Gll^Fdf, Gll^Fp, Gll^Fp, Gll^Fp, Gll^Fp, Gll^Fp, Gll^Fp, Gll^Fp, Isa, Isa, Isa, Gll^Fp, Gll^Fp, Gll^Fp, Gll^Fp, Gll^Fp, Gll^Fp, Gll^Fp, Gll^Fp, Gll^Fp, Gll^Fp, Gll^Fp, Gll^Fp, Gll^Fp, Gll^Fp, Gll^Fp, Gll^Fp, Gll^Fp, Gll^Fp, Gll^Fp
Gll^Fp, Gll^Fp, Gll^Fp, Gll^Fp, Gll^Fp, Gll^Fp, Gll^Fp, Gll^Fp, Gll^Fp, Gll^Fp, Gll^Fp, Gg^Ve, Gll^Fp, Gll^Fp, Gll^Fp, Isa, Isa, Isa, Gll^Fdf, Gll^Fdf, Gll^Fp, Gll^Fp, Gll^Fp, Gll^Fp, Gll^Fp, Gll^Fp, Gll^Fp, Gll^Fp, Gll^Fp, Gll^Fp, Gll^Fp, Gll^Fp, Gll^Fp, Gll^Fp, Isa, Gll^Fp
Gll^Fp, Gll^Fp, Gll^Fp, Gll^Fp, Gll^Fp, Gll^Fp, Gll^Fp, Gll^Fp, Gll^Fp, Gll^Fp, Gll^Fp, Gll^Fp, Gll^Fp, Gll^Fp, Gll^Fp, Gll^Fp, Gll^Fp, Isa, Isa, Gll^Fp, Gll^Fp, Gll^Fp, Gll^Fp, Gll^Fp, Gll^Fp, Gll^Fp, Gll^Fp, Gg^Fet, Gll^Fp, Gll^Fp, Gll^Fdf, Gll^Fp, Isa, Isa, Gll^Fp, Gll^Fp
Gll^Fp, Gll^Fp, Gll^Fp, Gll^Fp, Gll^Fp, Gll^Fp, Gll^Fp, Gll^Fp, Gll^Fp, Gll^Fp, Gll^Fp, Gll^Fp, Gll^Fp, Gll^Fp, Gll^Fp, Gll^Fp, Gll^Fp, Isa, Isa, Gll^Fp, Gll^Fdf, Gll^Fdf, Isa, Isa, Isa, Gll^Fp, Gll^Fp, Gll^Fp, Gll^Fp, Gll^Fp, Isa, Isa, Gll^Fp, Gll^Fp, Gll^Fp, Gll^Fp
Gll^Fp, Gll^Fp, Gg^Ve, Gll^Fp, Gll^Fp, Gll^Fp, Gll^Fp, Gll^Fdf, Gll^Fp, Gll^Fp, Gll^Fp, Gll^Fp, Gll^Fp, Gll^Fp, Gll^Fp, Gll^Fp, Gll^Fp, Isa, Isa, Gll^Fp, Gll^Fp, Gll^Fp, Isa, Isa, Isa, Gll^Fp, Gg^Ve, Gll^Fp, Isa, Isa, Gll^Fp, Gll^Fp, Gll^Fp, Gll^Fp, Gll^Fp, Gll^Fp
Gll^Fp, Gll^Fp, Gll^Fp, Gll^Fp, Gll^Fp, Gll^Fp, Gll^Fp, Gll^Fp, Gg^Fet, Gll^Fp, Gll^Fp, Gll^Fp, Gll^Fp, Gll^Fdf, Gll^Fp, Gll^Fp, Gll^Fp, Isa, Isa, Gll^Fp, Isa, Isa, Gll^Fp, Isa, Gll^Fp, Isa, Isa, Isa, Isa, Isa, Gll^Fp, Gll^Fp, Gll^Fp, Gll^Fp, Gll^Fp, Gll^Fp
Gll^Fp, Gll^Fp, Gll^Fp, Gll^Fp, Gll^Fp, Gll^Fp, Gll^Fp, Gll^Fp, Gll^Fp, Gll^Fp, Gll^Fp, Gll^Fp, Gll^Fp, Gll^Fp, Gll^Fp, Gll^Fp, Gll^Fp, Isa, Isa, Isa, Gll^Fp, Gll^Fp, Gll^Fdf, Gll^Fp, Gll^Fp, Isa, Gll^Fp, Gll^Fp, Gll^Fp, Isa, Gll^Fp, Gll^Fp, Gll^Fp, Gll^Fdf, Gll^Fp, Gll^Fp
Gll^Fp, Gll^Fp, Gll^Fp, Gll^Fp, Isa, Isa, Isa, Gll^Fp, Gll^Fp, Gll^Fp, Gll^Fdf, Gll^Fp, Gll^Fp, Gll^Fp, Gll^Fp, Gg^Ve, Gll^Fp, Isa, Isa, Gll^Fp, Gll^Fp, Gll^Fp, Gll^Fp, Gll^Fp, Gll^Fp, Gll^Fdf, Gll^Fp, Gll^Fp, Gll^Fp, Gg^Fet, Gll^Fp, Gll^Fp, Gll^Fp, Gll^Fp, Gll^Fp, Gll^Fp
Gll^Fp, Gll^Fp, Isa, Isa, Gll^Fp, Gll^Fdf, Gll^Fp, Isa, Isa, Gll^Fp, Gll^Fp, Gll^Fp, Gll^Fp, Gll^Fp, Gll^Fp, Gll^Fp, Isa, Isa, Isa, Gll^Fp, Gll^Fp, Gll^Fp, Gll^Fp, Gll^Fp, Gll^Fp, Gll^Fp, Gll^Fp, Gll^Fp, Gll^Fp, Gll^Fp, Gll^Fp, Gll^Fp, Gll^Fp, Gll^Fp, Gll^Fp, Gll^Fp
Gll^Fp, Isa, Gll^Fp, Gll^Fdf, Gll^Fp, Gll^Fp, Gll^Fp, Gll^Fp, Gll^Fp, Isa, Isa, Gll^Fp, Isa, Isa, Isa, Isa, Gll^Fp, Isa, Gll^Fdf, Isa, Gll^Fp, Gll^Fp, Gll^Fp, Gg^Ve, Gll^Fp, Gll^Fp, Gll^Fp, Gll^Fp, Gll^Fdf, Gll^Fp, Gll^Fp, Gll^Fp, Gll^Fp, Gll^Fp, Gll^Fp, Gll^Fp
Gll^Fp, Gll^Fp, Gll^Fp, Gll^Fp, Gll^Fp, Gll^Fp, Gll^Fp, Gll^Fp, Gll^Fp, Gll^Fp, Gll^Fp, Isa, Gll^Fdf, Isa, Gll^Fp, Gll^Fp, Gll^Fp, Isa, Isa, Isa, Gll^Fp, Gll^Fp, Gll^Fdf, Gll^Fp, Gll^Fp, Gll^Fp, Gll^Fp, Gll^Fp, Gll^Fp, Gll^Fp, Gll^Fp, Gll^Fp, Gll^Fp, Gg^Ve, Gll^Fp, Gll^Fp
Gll^Fp, Gll^Fp, Gll^Fp, Gll^Fp, Gll^Fp, Gll^Fp, Gll^Fp, Gg^Fet, Gll^Fp, Gll^Fp, Gll^Fp, Gll^Fp, Gll^Fp, Gll^Fp, Gll^Fp, Gll^Fp, Gll^Fp, Gll^Fp, Isa, Isa, Gll^Fp, Gll^Fp, Gll^Fp, Gll^Fp, Gll^Fp, Gll^Fp, Gll^Fp, Gll^Fp, Gll^Fp, Gll^Fp, Gll^Fp, Gll^Fp, Gll^Fp, Gll^Fp, Gll^Fp, Gll^Fp
Gll^Fp, Gll^Fp, Gll^Fp, Gll^Fp, Gll^Fp, Gll^Fp, Gll^Fdf, Gll^Fp, Gll^Fp, Gll^Fp, Gll^Fp, Gll^Fp, Gll^Fp, Gll^Fp, Gll^Fp, Gll^Fp, Gll^Fp, Gll^Fp, Isa, Isa, Gll^Fp, Gll^Fp, Gll^Fp, Gll^Fp, Gll^Fp, Gll^Fp, Gg^Ve, Gll^Fp, Gll^Fp, Gll^Fdf, Gll^Fp, Gll^Fp, Gll^Fp, Gll^Fp, Gll^Fp, Gll^Fp
Gll^Fp, Gll^Fp, Gll^Fp, Gll^Fp, Gll^Fp, Gll^Fp, Gll^Fp, Gll^Fp, Gll^Fp, Gll^Fp, Gll^Fp, Gll^Fp, Gll^Fp, Gll^Fp, Gll^Fp, Gll^Fp, Gll^Fp, Gll^Fp, Isa, Isa, Gll^Fp, Gll^Fp, Gll^Fp, Gll^Fp, Gll^Fp, Gll^Fp, Gll^Fp, Gll^Fp, Gll^Fp, Gll^Fp, Gll^Fp, Gll^Fp, Gll^Fp, Gll^Fp, Gll^Fp, Gll^Fp
Gll^Fp, Gll^Fp, Gll^Fp, Gll^Fp, Gll^Fp, Gll^Fp, Gll^Fp, Gll^Fp, Gll^Fp, Gll^Fp, Gll^Fp, Gll^Fp, Gll^Fp, Gll^Fp, Gll^Fp, Gll^Fp, Gg^Ve, Gll^Fp, Isa, Isa, Gll^Fp, Gll^Fp, Gll^Fp, Gll^Fp, Gll^Fp, Gll^Fp, Gll^Fp, Gll^Fp, Gll^Fp, Gll^Fp, Gg^Ve, Gll^Fp, Gll^Fp, Gll^Fp, Gll^Fp, Gll^Fp
Gll^Fp, Gll^Fp, Gll^Fp, Gll^Fp, Gg^Ve, Gll^Fp, Gll^Fp, Gll^Fp, Gll^Fp, Gll^Fp, Gll^Fp, Gll^Fp, Gg^Ve, Gll^Fp, Gll^Fp, Gll^Fp, Isa, Isa, Isa, Isa, Gll^Fp, Gll^Fp, Gll^Fp, Gll^Fp, Gll^Fp, Gll^Fp, Gll^Fp, Gll^Fp, Gll^Fp, Gll^Fp, Gll^Fp, Gll^Fp, Gll^Fp, Gll^Fp, Gg^Fet, Gll^Fp
Gll^Fp, Gll^Fp, Gll^Fp, Gll^Fp, Gll^Fp, Gll^Fp, Gll^Fp, Gll^Fp, Gll^Fp, Gll^Fp, Gll^Fp, Gll^Fp, Gll^Fp, Gll^Fp, Gll^Fp, Isa, Cv, Cv, Cv, Isa, Gll^Fp, Gg^Ve, Gll^Fp, Gll^Fp, Gll^Fp, Gll^Fp, Gg^Ve, Gll^Fp, Gll^Fp, Gll^Fp, Gll^Fp, Gll^Fp, Gll^Fp, Gll^Fp, Gll^Fp, Gll^Fp
Gll^Fp, Gll^Fp, Gll^Fp, Gll^Fp, Gll^Fp, Gg^Ve, Gll^Fp, Gll^Fp, Gll^Fp, Gll^Fp, Gg^Ve, Gll^Fp, Gll^Fp, Gll^Fp, Cv, Cv, Gll^Fp, Gll^Fp, Gll^Fp, Cv, Cv, Gll^Fp, Gll^Fp, Gll^Fp, Gll^Fp, Gll^Fp, Gll^Fp, Gll^Fp, Gll^Fp, Gll^Fp, Gll^Fp, Gll^Fp, Gll^Fp, Gll^Fp, Gll^Fp, Gll^Fp
Gll^Fp, Gll^Fp, Gll^Fp, Gll^Fp, Gll^Fp, Gll^Fp, Gll^Fp, Gll^Fp, Gll^Fp, Gll^Fp, Gll^Fp, Gll^Fp, Gll^Fp, Cv, Gll^Fp, Gll^Fp, Ww^Ewf, Ww^Ewf, Ww^Ewf, Gll^Fp, Gll^Fp, Cv, Gll^Fp, Gll^Fp, Gg^Ve, Gll^Fp, Gll^Fp, Gll^Fp, Gll^Fp, Gll^Fp, Gll^Fp, Gll^Fp, Gll^Fp, Gll^Fp, Gll^Fp, Gll^Fp
Gll^Fp, Gll^Fp, Gll^Fp, Gll^Fp, Gll^Fp, Gll^Fp, Gll^Fp, Gll^Fp, Gll^Fp, Gll^Fp, Gll^Fp, Gll^Fp, Gll^Fp, Cv, Gll^Fp, Gll^Efm, Ww^Ewf, Gll^Fp, Ww^Ewf, Gll^Fp, Gll^Fp, Cv, Gll^Fp, Gll^Fp, Gll^Fp, Gll^Fp, Gll^Fp, Gll^Fp, Gll^Fp, Gll^Fp, Gll^Fp, Gll^Fp, Gll^Fp, Gg^Ve, Gll^Fp, Gll^Fp
Gll^Fp, Gll^Fp, Gll^Fp, Gll^Fp, Gg^Ve, Gll^Fp, Gll^Fp, Gg^Ve, Gll^Fp, Gll^Fp, Gll^Fp, Gll^Fp, Gll^Fp, Cv, Gll^Fp, Gll^Efm, Ww^Ewf, Gg^Ve, Ww^Ewf, Gll^Efm, Gll^Fp, Cv, Gll^Fp, Gll^Fp, Gll^Fp, Gll^Fp, Cv, Gll^Fp, Gll^Fp, Gg^Ve, Gll^Fp, Gll^Fp, Gll^Fp, Gll^Fp, Gll^Fp, Gll^Fp
Gll^Fp, Gll^Fp, Gll^Fp, Gll^Fp, Gll^Fp, Gll^Fp, Gll^Fp, Gll^Fp, Cv, Cv, Cv, Gll^Fp, Gll^Fp, Cv, Cv, Gll^Fp, Gll^Fp, Ww^Ewf, Gll^Fp, Gll^Fp, Cv, Cv, Gll^Fp, Gll^Fp, Cv, Cv, Cv, Cv, Cv, Gll^Fp, Gll^Fp, Gll^Fp, Gg^Ve, Gll^Fp, Gll^Fp, Gll^Fp
Gll^Fp, Gg^Ve, Gll^Fp, Gll^Fp, Gll^Fp, Gll^Fp, Cv, Cv, Cv, Cv, Cv, Cv, Cv, Gll^Fp, Gll^Fp, Cv, Cv, Gll^Fp, Cv, Cv, Gll^Fp, Gll^Fp, Cv, Cv, Cv, Cv, Gll^Fp, Gll^Fp, Gll^Fp, Cv, Cv, Gll^Fp, Gll^Fp, Gll^Fp, Gll^Fp, Gll^Fp
Gll^Fp, Gll^Fp, Gll^Fp, Gll^Fp, Cv, Cv, Cv, Cv, Gll^Fp, Gll^Fp, Gll^Fp, Cv, Cv, Cv, Cv, Gll^Fp, Cv, Cv, Cv, Gll^Fp, Cv, Cv, Cv, Cv, Gll^Fp, Gll^Fp, Ww^Ewl, Gll^Fp, Gll^Fp, Gll^Fp, Cv, Cv, Cv, Gll^Fp, Gll^Fp, Gll^Fp
Cv, Gll^Fp, Cv, Cv, Cv, Cv, Cv, Gll^Fp, Ww^Ewl, Ww^Ewl, Ww^Ewf, Gll^Fp, Gll^Efm, Cv, Cv, Cv, Cv, Cv, Cv, Cv, Cv, Cv, Gll^Fp, Gll^Fp, Gll^Fp, Ww^Ewl, Gg^Fet, Ww^Ewl, Gg^Ve, Gll^Fp, Cv, Cv, Gll^Fp, Cv, Cv, Gll^Fp
Cv, Cv, Cv, Cv, Gll^Fp, Cv, Cv, Gll^Fp, Ww^Ewf, Gg^Fet, Gll^Fp, Gll^Fp, Cv, Gll^Fp, Gll^Fp, Cv, Cv, Cv, Cv, Cv, Gll^Fp, Gll^Fp, Gll^Efm, Gll^Fp, Gg^Ve, Ww^Ewf, Ww^Ewl, Ww^Ewf, Cv, Cv, Cv, Cv, Cv, Gll^Fp, Cv, Gll^Fp
Gll^Fp, Cv, Gll^Fp, Gll^Fp, Cv, Cv, Gg^Ve, Gll^Fp, Gll^Fp, Gll^Fp, Cv, Gg^Ve, Kv, Cv, Cv, Gll^Fp, Gll^Fp, Cv, Cv, Gll^Fp, Gll^Fp, Gll^Fp, Cv, Cv, Cv, Gll^Fp, Gll^Fp, Gll^Fp, Cv, Kv, Kv, Kv, Cv, Gll^Fp, Cv, Gll^Fp
Gll^Fp, Cv, Gll^Fp, Cv, Gg^Ve, Kv, Cv, Cv, Gll^Fp, Gll^Fp, Cv, Kv, Kv, Kv, Cv, Gll^Fp, Gg^Fet, Cv, Cv, Gg^Fet, Gll^Fp, Cv, Kv, Kv, Kv, Gg^Ve, Gll^Fp, Gll^Fp, Cv, Cv, Kv, Cv, Gg^Ve, Gll^Fp, Cv, Gll^Fp
Gll^Fp, Cv, Gll^Fp, Cv, Kv, Kv, Kv, Gg^Ve, Gll^Fp, Gll^Efm, Gll^Fp, Cv, Cv, Gg^Ve, Gll^Fp, Gll^Fp, Gll^Fp, Cv, Cv, Gll^Fp, Gll^Fp, Cv, Gg^Ve, Kv, Cv, Cv, Gll^Efm, Gll^Fp, Gll^Fp, Gg^Ve, Cv, Cv, Gll^Fp, Gll^Fp, Cv, Gll^Fp
Gll^Fp, Cv, Cv, Gll^Fp, Gll^Fp, Cv, Cv, Gll^Fp, Gll^Fp, Gll^Fp, Gll^Fp, Gll^Fp, Gll^Efm, Gll^Fp, Gll^Fp, Gll^Fp, Cv, Cv, Cv, Cv, Cv, Gll^Fp, Gll^Fp, Cv, Gll^Fp, Gll^Fp, Ww^Ewf, Ww^Ewl, Ww^Ewl, Gll^Fp, Cv, Cv, Cv, Cv, Cv, Cv
Gll^Fp, Cv, Cv, Cv, Cv, Cv, Cv, Gll^Fp, Ww^Ewl, Ww^Ewf, Ww^Ewl, Gll^Fp, Gll^Fp, Gll^Fp, Cv, Cv, Cv, Cv, Gll^Fp, Cv, Cv, Cv, Cv, Gll^Fp, Gll^Fp, Ww^Ewf, Ww^Ewl, Gg^Fet, Ww^Ewl, Gll^Fp, Cv, Cv, Cv, Cv, Gll^Fp, Gll^Fp
Gll^Fp, Gll^Fp, Gll^Fp, Cv, Cv, Cv, Cv, Gll^Fp, Gll^Fp, Gg^Fet, Gll^Fp, Gll^Fp, Cv, Cv, Cv, Cv, Gll^Fp, Gll^Fp, Gll^Efm, Gll^Fp, Gll^Fp, Cv, Cv, Cv, Cv, Gll^Fp, Gll^Fp, Ww^Ewl, Cv, Cv, Cv, Cv, Gll^Fp, Gll^Fp, Gll^Fp, Gll^Fp
Gll^Fp, Gll^Fp, Gll^Fp, Gll^Fp, Gll^Fp, Cv, Cv, Cv, Cv, Gll^Fp, Cv, Cv, Cv, Cv, Gll^Fp, Gll^Fp, Gg^Fet, Gll^Fp, Ww^Ewl, Gg^Fet, Gg^Fet, Gll^Fp, Gll^Fp, Cv, Cv, Cv, Cv, Cv, Cv, Cv, Gll^Fp, Gll^Fp, Gll^Fp, Gll^Fp, Gll^Fp, Gll^Fp
Gll^Fp, Gll^Fp, Gg^Ve, Gll^Fp, Gll^Efm, Gll^Fp, Gll^Fp, Cv, Cv, Cv, Cv, Cv, Gll^Fp, Gll^Fp, Gll^Fp, Gg^Fet, Gg^Fet, Ww^Ewl, Ww^Ewl, Gg^Fet, Gg^Fet, Gll^Fp, Gll^Fp, Gll^Fp, Cv, Cv, Cv, Cv, Gll^Fp, Gll^Fp, Gll^Fp, Gll^Fp, Gg^Ve, Gll^Efm, Gll^Fp, Gll^Fp
Gll^Fp, Gll^Fp, Gll^Fp, Gll^Fp, Gll^Fp, Gll^Fp, Gll^Fp, Gll^Fp, Gll^Fp, Cv, Cv, Cv, Cv, Gll^Efm, Gll^Fp, Gg^Fet, Gg^Fet, Ww^Ewf, Gll^Fp, Gg^Fet, Gll^Efm, Gll^Fp, Cv, Cv, Cv, Cv, Gll^Fp, Gll^Fp, Gll^Fp, Gll^Fp, Gg^Ve, Gll^Fp, Gll^Fp, Gll^Fp, Gll^Fp, Gll^Fp
Gll^Fp, Gll^Fp, Gll^Fp, Gll^Fp, Gll^Fp, Gll^Fp, Gg^Ve, Gll^Fp, Gll^Fp, Gll^Fp, Gll^Fp, Cv, Cv, Cv, Cv, Gll^Fp, Gll^Fp, Gll^Fp, Gll^Fp, Gll^Fp, Cv, Cv, Cv, Cv, Gll^Fp, Gll^Fp, Gll^Fp, Gll^Fp, Gll^Fp, Gll^Efm, Gll^Fp, Gll^Fp, Gll^Fmf, Gll^Efm, Gll^Fp, Gll^Fp
Gll^Fp, Gll^Fp, Gll^Fp, Gll^Fp, Gll^Fdf, Gll^Fp, Gll^Fp, Gll^Efm, Gll^Efm, Gll^Fp, Gll^Fp, Gll^Fp, Gll^Fp, Cv, Cv, Cv^Efm, Cv, Gll^Fp, Cv, Cv, Cv, Cv, Gll^Fp, Gll^Fp, Gll^Efm, Gll^Fp, Gg^Ve, Gll^Fp, Gll^Fp, Gll^Fp, Gll^Fp, Gll^Fmf, Gll^Fp, Gll^Fp, Gll^Fp, Gll^Fp
Gll^Fp, Gll^Fp, Gll^Fp, Gll^Fp, Gll^Fp, Gll^Fp, Gll^Fp, Gll^Efm, Gll^Fp, Gll^Fp, Gg^Ve, Gll^Fp, Gll^Fp, Gll^Fp, Gll^Fp, Cv, Cv, Cv, Cv, Cv, Gll^Fp, Gll^Fp, Gll^Fp, Gll^Fp, Gll^Fp, Gll^Fp, Gll^Fp, Gll^Fp, Gll^Fp, Gll^Efm, Gll^Fmf, Gll^Fmf, Gll^Efm, Gll^Fp, Gll^Fp, Gll^Fp
Gll^Fp, Gll^Efm, Gll^Fp, Gll^Fp, Gll^Fp, Gll^Fp, Gll^Efm, Gll^Fp, Gll^Fdf, Gll^Fp, Gll^Efm, Gll^Fp, Gll^Efm, Gll^Fp, Gll^Fp, Gll^Fp, Gll^Fp, Cv, Isa, Isa, Gll^Fp, Gll^Fp, Gll^Efm, Gg^Ve, Gll^Fp, Gll^Fp, Gll^Efm, Gll^Fp, Gll^Fp, Gll^Fmf, Gll^Fmf, Gll^Fp, Gll^Fp, Gll^Fp, Gll^Fp, Gll^Efm
Gll^Fp, Gll^Fp, Gll^Fp, Gg^Ve, Gll^Fp, Gll^Fp, Gll^Fp, Gll^Fp, Gll^Fp, Gll^Fp, Gll^Efm, Gll^Fp, Gll^Fp, Gg^Ve, Gll^Fp, Gll^Fp, Gll^Fp, Gll^Fp, Isa, Isa, Gg^Ve, Gll^Fp, Gll^Fp, Gll^Fp, Gll^Fmf, Gll^Fp, Gll^Fdf, Gll^Fdf, Gll^Fdf, Gll^Fdf, Gll^Fp, Gll^Fp, Gg^Ve, Gll^Fp, Gll^Fp, Gll^Fp
Gll^Fp, Gll^Fp, Gll^Fp, Gll^Fp, Gll^Fdf, Gll^Fp, Gll^Fp, Gll^Fp, Gll^Fp, Gll^Fp, Gll^Fp, Gll^Fp, Gll^Fp, Gll^Fp, Gll^Fdf, Gll^Efm, Gll^Fp, Gll^Efm, Isa, Isa, Gll^Efm, Gll^Fp, Gll^Fp, Gll^Fp, Gll^Fp, Gll^Fdf, Gll^Fp, Gll^Fp, Gll^Fp, Gll^Fp, Gll^Fp, Gll^Fp, Gll^Fp, Gll^Fp, Gll^Fp, Gll^Fp
Gll^Fp, Gll^Fp, Gll^Fdf, Gll^Fp, Gll^Fp, Gll^Fp, Gll^Fp, Gll^Fp, Gg^Ve, Gll^Fp, Gll^Fp, Gll^Fdf, Gll^Fp, Gll^Fp, Gll^Fp, Gll^Fp, Gll^Fp, Gll^Fp, Isa, Isa, Gll^Fp, Gll^Fp, Gll^Fp, Gll^Fp, Gll^Fp, Gll^Fp, Gll^Fp, Gll^Fp, Gll^Fp, Gg^Ve, Gll^Fp, Gll^Fp, Gll^Fp, Gll^Fp, Gll^Fp, Gll^Fp
Gll^Fp, Gll^Fp, Gll^Fp, Gll^Fp, Gll^Fp, Gll^Fp, Gll^Fp, Gll^Fdf, Gll^Fp, Gll^Fdf, Gll^Fp, Gll^Fp, Gll^Fdf, Gll^Fp, Gll^Fdf, Gll^Fp, Gll^Fp, Gll^Fp, Isa, Isa, Gll^Fp, Gll^Fp, Gll^Fp, Gll^Fp, Gg^Ve, Gll^Fp, Gll^Fp, Gll^Fp, Gll^Fp, Gll^Fp, Gll^Fp, Gll^Fmf, Gll^Fmf, Gll^Fmf, Gll^Fp, Gll^Fp
Gll^Fp, Gll^Fp, Gll^Fp, Gll^Fp, Gll^Fp, Gll^Fp, Gll^Fp, Gll^Fp, Gll^Fp, Gll^Fp, Gll^Fp, Gll^Fp, Gll^Fp, Gll^Fp, Gll^Fp, Gll^Fp, Gg^Ve, Gll^Fp, Isa, Isa, Gll^Fp, Gll^Fp, Gll^Fp, Gll^Fp, Gll^Fp, Isa, Gll^Fp, Gll^Fp, Gll^Fp, Gll^Fp, Gll^Fp, Gll^Fp, Gll^Fmf, Gll^Fp, Gll^Fp, Gll^Fp
Gll^Fp, Gll^Fp, Gll^Fp, Gll^Fp, Gll^Fp, Gll^Fp, Gll^Fp, Gll^Fp, Gll^Fp, Gll^Fp, Isa, Gll^Fp, Gll^Fp, Gll^Fp, Gll^Fp, Gll^Fp, Gll^Fp, Gll^Fp, Isa, Isa, Gll^Fp, Gll^Fp, Gll^Fp, Gll^Fp, Isa, Isa, Gll^Fp, Gll^Fp, Gll^Fdf, Gll^Fp, Gll^Fp, Gll^Fp, Gll^Fp, Gll^Fp, Isa, Gll^Fp
Gll^Fp, Gll^Fp, Gll^Fp, Gll^Fp, Gg^Ve, Gll^Fp, Gll^Fp, Gll^Fp, Gll^Fp, Isa, Gll^Fdf, Isa, Isa, Isa, Isa, Gll^Fp, Isa, Isa, Isa, Isa, Gll^Fp, Gll^Fp, Isa, Isa, Isa, Isa, Isa, Gll^Fp, Gll^Fp, Gll^Fp, Gll^Fp, Gg^Ve, Isa, Isa, Gll^Fp, Gll^Fp
Gll^Fp, Gll^Fp, Gll^Fp, Gll^Fp, Gll^Fp, Gll^Fp, Gll^Fp, Gll^Fmf, Gll^Fp, Isa, Isa, Isa, Gll^Fp, Gll^Fp, Gll^Fp, Isa, Isa, Isa, Isa, Isa, Isa, Isa, Gll^Fp, Gll^Fp, Gll^Fp, Gll^Fp, Gll^Fp, Isa, Isa, Isa, Isa, Isa, Gll^Fp, Gll^Fdf, Gll^Fp, Gll^Fp
Gll^Fp, Gll^Fp, Gll^Fmf, Gll^Fp, Gll^Fdf, Gll^Fp, Isa, Gll^Fp, Isa, Isa, Gll^Fp, Gll^Fp, Gg^Ve, Gll^Fp, Gll^Fp, Gll^Fp, Gll^Fp, Gll^Fp, Isa, Isa, Isa, Gll^Fp, Gg^Ve, Gll^Fp, Gll^Fp, Gll^Fp, Gll^Fp, Gll^Fp, Gll^Fp, Isa, Isa, Gll^Fmf, Gll^Fp, Gll^Fp, Gll^Fp, Gll^Fp
Gll^Fp, Gll^Fp, Isa, Isa, Isa, Isa, Isa, Isa, Gll^Fp, Gll^Fp, Gll^Fp, Gll^Fp, Gll^Fp, Gll^Fp, Gll^Fp, Gll^Fmf, Gll^Fp, Gll^Fp, Isa, Isa, Gll^Fp, Gll^Fp, Gll^Fp, Gll^Fp, Gll^Fp, Gll^Fp, Gll^Fp, Gg^Ve, Gll^Fp, Gll^Fdf, Gll^Fp, Gll^Fp, Gll^Fp, Gll^Fp, Gll^Fp, Gll^Fp
Isa, Isa, Gll^Fdf, Isa, Isa, Isa, Gll^Fp, Gll^Fp, Gg^Ve, Gll^Fp, Gll^Fp, Gll^Fp, Gll^Fp, Gll^Fmf, Gll^Fp, Gll^Fdf, Gll^Fp, Gll^Fp, Isa, Isa, Gll^Fp, Gll^Fp, Gll^Fp, Gll^Fp, Gll^Fp, Gll^Fp, Gll^Fp, Gll^Fp, Gll^Fp, Gll^Fp, Gll^Fp, Gll^Fp, Gll^Fp, Gg^Ve, Gll^Fp, Gll^Fp
Isa, Isa, Gll^Fp, Gll^Fp, Gll^Fp, Gll^Fdf, Gll^Fp, Gll^Fp, Gll^Fp, Gll^Fp, Gll^Fp, Gll^Fp, Gll^Fp, Gll^Fp, Gll^Fp, Gll^Fmf, Gll^Fp, Gll^Fp, Isa, Isa, Gll^Fp, Gll^Fp, Gll^Fp, Gll^Fp, Gll^Fp, Gll^Fp, Gll^Fp, Gll^Fp, Gll^Fp, Gll^Fp, Gll^Fp, Gll^Fmf, Gll^Fp, Gll^Fp, Gll^Fmf, Gll^Fp
Gll^Fp, Gll^Fp, Gll^Fp, Gll^Fp, Gll^Fp, Gll^Fp, Gll^Fp, Gll^Fp, Gll^Fp, Gll^Fp, Gll^Fdf, Gll^Fp, Gll^Fp, Gll^Fp, Gll^Fp, Gll^Fp, Gll^Fp, Gll^Fp, Isa, Isa, Gll^Fp, Gll^Fdf, Gll^Fp, Gll^Fp, Gll^Fp, Gll^Fp, Gll^Fp, Gll^Fp, Gll^Fp, Gg^Ve, Gll^Fp, Gll^Fp, Gll^Fp, Gll^Fp, Gll^Fp, Gll^Fp
Gll^Fp, Gll^Fp, Gll^Fp, Gg^Ve, Gll^Fp, Gll^Fp, Gll^Fp, Gll^Fp, Gll^Fp, Gll^Fp, Gll^Fp, Gll^Fp, Gll^Fp, Gg^Ve, Gll^Fp, Gll^Fp, Gll^Fp, Gll^Fp, Isa, Isa, Gll^Fp, Gll^Fp, Gll^Fp, Gll^Fp, Gg^Ve, Gll^Fp, Gll^Fp, Gll^Fp, Gll^Fp, Gll^Fp, Gll^Fmf, Gll^Fdf, Gll^Fp, Gll^Fdf, Gll^Fp, Gll^Fp
Gll^Fp, Gll^Fp, Gll^Fp, Gll^Fp, Gll^Fdf, Gll^Fp, Gll^Fp, Gll^Fp, Gll^Fdf, Gll^Fp, Gll^Fp, Gll^Fp, Gll^Fp, Gll^Fp, Gll^Fp, Gll^Fp, Gll^Fp, Gll^Fp, Isa, Isa, Gll^Fp, Gll^Fp, Gll^Fp, Gll^Fp, Gll^Fp, Gll^Fp, Gll^Fp, Gll^Fp, Gll^Fp, Gll^Fp, Gll^Fp, Gll^Fp, Gll^Fp, Gll^Fp, Gll^Fp, Gll^Fp
Gll^Fp, Gll^Fp, Gll^Fp, Gll^Fp, Gll^Fp, Gll^Fp, Gll^Fp, Gll^Fp, Gll^Fp, Gll^Fp, Gll^Fp, Gll^Fp, Gll^Fp, Gll^Fp, Gll^Fp, Gll^Fp, Gll^Fp, Gll^Fp, Gll^Fp, Isa, Isa, Gll^Fp, Gll^Fp, Gll^Fp, Gll^Fp, Gll^Fp, Gll^Fp, Gll^Fp, Gll^Fp, Gll^Fp, Gll^Fp, Gll^Fp, Gll^Fp, Gll^Fp, Gll^Fp, Gll^Fp
