Gg, Gg, Gll^Fp, Gg, Gll^Fp, Gll^Fp, Gll^Fp, Gll^Fp, Hhd^Fp, Gll^Fp, Gll^Fp, Gll^Fp, Gll^Fp, Gll^Fp, Gg^Qhhf, Gll^Fp, Gll^Qhhf, Gll^Fp, Gll^Fp, Gll^Fp, Gg^Efm, Gg, Gll^Fp, Gll^Fp, Gll^Fp, Gll^Fp, Wog, Gg, Gg
Gll^Fp, Gll^Fp, Gll^Fp, Gll^Vft5, Hhd^Fp, Gll^Fp, Gll^Fp, Gll^Fp, Hhd^Fp, Hhd^Fp, Gll^Fp, Gll^Fp, Gll^Fp, Gll^Qhhf, Aa^Fpa, Gll^Qhhf, Gll^Fp, Gll^Qhhf, Gll^Qhhf, Gll^Fp, Gll^Fp, Gll^Fmw, Gll^Fp, Gll^Fp, Wog, Wog, Wog, Gll^Fp, Gll^Fp
Gll^Fp, Gll^Fp, Gll^Fp, Hhd^Fp, Hhd^Fp, Aa^Fda, Hhd^Fp, Gll^Fp, Hhd^Fp, Wwg^Ewl, Gll^Fp, Gll^Fp, Gll^Qhhf, Gll^Qhhf, Hhd^Fp, Aa^Fda, Gll^Fp, Gg^_mh, Hhd^Fp, Gll^Qhhf, Gll^Fmw, Gll^Fp, Wwg^Ewl, Gll^Fp, Wog, Wog, Aa^Fma, Gll^Fp, Gll^Fp
Gll^Fp, Gll^Fp, Gll^Fp, Gll^Fp, Gll^Fp, Hhd^Fp, Hhd, Hhd^Fp, Gll^Fp, Gll^Fp, Wwg^Ewl, Wwg^Ewl, Gll^Qhhf, Hhd^Fp, Gll^Vft3, Gll^Fmw, Gll^Fmw, Gg^Efm, Gll^Qhhf, Gll^Qhhf, Hhd^Fp, Wwg^Ewl, Gll^Fp, Wog, Wog, Aa^Fma, Hhd^Fds, Gs^Fds, Gll^Fp
Gg, Gll^Fp, Ww^Ewl, Gll^Fmw, Gll^Fp, Gll^Fp, Gll^Fp, Gll^Fdf, Hhd^Fdf, Gll^Fp, Gll^Fp, Gll^Qhhf, Aa^Fda, Hhd^Fp, Hhd^Fp, Gll^Fmw, Gll^Qhhf, Gg^Efm, Gll^Qhhf, Hhd^Fp, Hhd^Fdf, Gll^Fp, Gll^Fp, Wog, Gll^Fp, Aa^Fpa, Hhd^Fp, Gs^Fds, Gll^Fp
Gg, Gg^Em, Gll^Fp, Gll^Fp, Gll^Fmw, Hhd^Fdf, Gs^Fds, Gll^Fdf, Gll^Fp, Gll^Fp, Gll^Fdf, Gll^Qhhf, Gll^Qhhf, Gll^Fp, Gll^Qhhf, Gll^Qhhf, Gg^Efm, Gll^Qhhf, Gg^Efm, Gll^Fp, Hhd^Fp, Wog, Wog, Wog, Gll^Vft2, Gll^Fdf, Hhd^Fdf, Gll^Fdf, Gll^Fp
Gg, Gll^Fp, Gll^Fp, Gll^Fp, Gll^Fmw, Gll^Fp, Gll^Qhhf, Gll^Fp, Gll^Fmw, Gll^Vft1, Gll^Fdf, Gll^Fp, Gll^Fmw, Gll^Qhhf, Gg^Efm, Gg^Efm, Gll^Fp, Gll^Fp, Wog, Gll^Fdf, Wog, Wog, Wog, Gll^Fp, Aa^Fpa, Aa^Fma, Hhd^Fds, Gll^Fdf, Gll^Fp
Gg, Gll^Fp, Gll^Fp, Gll^Fmw, Gll^Qhhf, Gll^Qhhf, Gg^_mh, Gll^Qhhf, Gll^Fp, Gll^Fmw, Gll^Fp, Gll^Fp, Gg^Efm, Gll^Fmw, Gll^Fp, Gll^Fp, Gll^Fp, Gll^Fdf, Gll^Fp, Wog, Wog, Wwg^Ewl, Wog, Gll^Fdf, Gll^Fp, Gll^Fmw, Hhd^Fp, Gll^Fmw, Gll^Fp
Gg, Gll^Fp, Gll^Qhhf, Gll^Qhhf, Gll^Qhhf, Gll^Fmw, Gg^Emf, Gll^Qhhf, Gll^Fmw, Gll^Fp, Gs^Fds, Gll^Fmw, Gg^Efm, Gll^Fdw, Urb^Qhh, Gll^Fp, Gs^Fds, Gll^Vft2, Gs^Fds, Gll^Fdf, Gll^Fdf, Wog, Gll^Fp, Aa^Fma, Gs^Fds, Gll^Fdf, Hhd^Fp, Gll^Fp, Gll^Fdf
Gg^Efm, Gg^Efm, Gll^Qhhf, Gll^Fmw, Gll^Fp, Gll^Fp, Gs^Qhhf, Gll^Qhhf, Gg, Gll^Fp, Gg^Efm, Gll^Fdw, Rb^Fdw, Urb^Qhh, Urb^Fp, Rb^Fp, Aa^Fda, Gs^Fds, Gs^Fdw, Gll^Fp, Gll^Fdf, Wog, Wog, Gll^Fmw, Aa^Fda, Gll^Fp, Aa^Fma, Hhd^Fp, Wog
Gg^Efm, Gll^Fmw, Gll^Qhhf, Gll^Vft2, Gll^Fp, Gll^Fp, Gs^Qhhf, Gll^Fmw, Ur, Gs, Rb^Fp, Ur^Fdw, Isa, Isa, Isa^Em, Urb^Fds, Rb^Emf, Gd^Fetd, Gll^Fdf, Gll^Fdw, Gs^Fds, Gll^Fp, Wog, Gs^Fds, Wog, Gll^Fp, Gll^Fdf, Wog, Gll^Fp
Gg, Gll^Fp, Gll^Fp, Gll^Qhhf, Gll^Qhhf, Gll^Qhhf, Gll^Fp, Gg, Ur, Rb^Feth, Gll^Fp, Isa^Fp, Gll^Fp, Gll^Fp, Isa^Em, Isa, Isa^Fp, Rb^Fp, Rb^Feth, Ur^Em, Rb^Fp, Wog, Gs^Fds, Wog, Wog, Wog, Gll^Fp, Gll^Fp, Gs^Fds
Gll^Fp, Gll^Fp, Gg, Gll^Fp, Gll^Fp, Gs^Fds, Ur, Gll^Fdw, Ur, Urb^Qhh, Isa^Fp, Isa, Isa, Isa, Urb^Qhh, Isa, Isa^Fp, Rb^Emf, Ur, Rb^Fp, Wog, Wog, Gll^Fp, Gll^Fp, Gs^Fds, Gll^Fp, Gll^Fp, Gs^Fds, Gs^Fds
Gg, Gg, Gll^Fp, Gs^Fds, Gg^Efm, Gg, Ur, Ur, Gll^Fp, Isa, Gll^Fp, Rb^Feth, Exos^Cov, Exos^Cov, Exos^Cov, Isa^Em, Isa^Fp, Rb^Fp, Gll^Fp, Gg^Efm, Wog, Gll^Fp, Gll^Vft2, Gs^Fds, Gs^Fds, Gll^Fp, Gs^Fds, Gs^Fds, Wog
Gg, Gll^Fp, Gg, Gll^Fp, Gll^Fp, Ur, Gs, Ur, Gll^Fdw, Urb^Qhh, Rb^Fp, Exos^Cov, Exos^Cov, 2 Exos^Kov, Exos^Cov, Exos^Cov, Rb^Fp, Rb^Fp, Wog, Wog, Gll^Fp, Gll^Fp, Gll^Fp, Gll^Fp, Gll^Fp, Gs^Fds, Wwrg, Wog, Wog
Gg, Gg, Gll^Fp, Gll^Fp, Gg, Gg, Ur, Ur, Ur^Em, Rb^Fp, Rb^Fp, Isa^Fdw, Isa, Exos^Cov, Isa, Rb^Feth, Rb^Fp, Rb^Fp, Wog, Gll^Fp, Gll^Fp, Gll^Fp, Gll^Fp, Gs^Fds, Wwrg, Gll^Fp, Wog, Wog, Wog^Qhux
Gg, Gg, Gll^Fp, Gg, Gs, Gs, Ur, Urb^Qhh, Gll^Fdw, Ur, Urb^Qhh, Isa, Isa^Em, Ur^Em, Rb^Fp, Rb^Fp, Gll^Fdw, Wog, Urb^Qhh, Wog, Gll^Fp, Gll^Fp, Gll^Fp, Gll^Fp, Wwrg, Gs^Fds, Wog, Wog, Wog^Qhux
Gg, Gll^Fp, Gll^Fp, Gg, Gs, Gs, Urb^Qhh, Gll^Fdw, Gll^Fdw, Urb^Qhh, Ur, Rb^Fp, Ur, Isa^Efm, Ur, Ur^Emf, Wog, Gll^Fdw, Gg, Wog, Gll^Fp, Gll^Fp, Gll^Fp, Gll^Fp, Wog, Wog, Wog, Wog^Qhux, Wog^Qhux
Gg, Gll^Fp, Gg, Gs, Re, Re, Gs, Gll^Fdw, Gg, Ur^Em, Ur, Ur^Em, Ur, Urb^Qhh, Urb^Qhh, Ur^Em, Urb^Qhh, Urb^Qhh, Gll^Em, Wog, Wwf, Gll^Fp, Wog, Wog, Wog, Wog, Wog^Qhux, Wog^Qhux, Wog
Gg, Gg, Gs, Gs, Re, Gg, Gs, Gll^Fp, Gll^Fp, Gg, Gg, Gg, Urb^Qhh, Urb^Qhh, Gll^Fp, Urb^Qhh, Gll^Fdw, Gll^Fp, Gll^Fp, Wwf, Wwf, Ds, Wog, Wog, Wog^Qhux, Wog^Qhux, Wog^Qhux, Wog, Wog
Gll, Gll^Fp, Gll^Fp, Re, Re, Gs, Gg, Gll^Fp, Gg, Gg, Gg, Gg^Efm, Gg, Gll^Fp, Gll^Fp, Gll^Fp, Gs, Gll, Wwrg, Wwf, Wwrg, Rrd, Wog, Wog, Wog^Qhux, Wog^Qhux, Wog, Wog, Ds
Gll, Gll^Emf, Gll^Fp, Re, Re, Gs, Gg, Gg, Gs, Gs, Gs, Gg, Gll, Gll, Gll^Em, Gll^Em, Gg, Gll^Fp, Gg, Gg, Ds, Ds, Wog, Wog, Wog, Wog, Wog, Ds, Rrd
Gg, Gll^Fp, Gs, Gg, Gg, Gs, Gg, Gg, Gg, Gg, Gll^Fp, Gll^Fp, Gll^Fp, Gll^Fp, Gll^Fp, Gg, Gs^Efm, Gg, Gg, Gg, Ds, Wog, Wog, Wog^Qhux, Wog^Qhux, Wog, Ds, Rrd, Ds
Gll^Fp, Gll^Fp, Gs, Gg, Gg, Gs, Gg, Gg, Gg, Gg, Gs, Gs, Gll, Gll^Fp, Gll^Fp, Gg, Gg^Efm, Gg^Efm, Rrd, Ds, Wog, Wog, Wog, Wog^Qhux, Wog^Qhux, Wog, Ds, Rrd, Wog
Gg, Gll^Fp, Gg, Gs, Gg, Re, Re, Gg, Gg, Gg, Gg, Gs, Gs, Gll^Fp, Gll^Fp, Gll^Fp, Gll^Fp, Gg^Efm, Wwf, Rrd, Ds, Wog, Wog^Qhux, Wog^Qhux, Wog, Wog, Wog, Wog, Rd
Gg, Gg, Gll^Fp, Gs, Gll^Em, Re, Gg, Re, Re, Re, Gll^Fp, Gg, Gg, Gs, Gll^Fp, Gll^Em, Wwrg, Wwrg, Wwf, Rrd, Wwf, Wog, Wog, Wog^Qhux, Wog, Wog, Ds, Ds, Rd
Gg, Gg, Gll^Fp, Gll^Fp, Gll^Fp, Gll^Fp, Gll, Gg, Re, Re, Gll^Fp, Gll, Gll, Gs, Gs, Gg, Gll^Fp, Gg, Gg, Wwf, Rrd, Rrd, Wog, Wog, Wog, Wog, Ds, Rd, Ds
Gg, Gg, Gs, Gll^Emf, Gll^Fp, Gll^Em, Gs, Gs, Re, Re, Gg, Gll^Fp, Gll^Em, Gll^Fp, Gll^Fp, Gll^Em, Gll^Fp, Gll, Gg, Wwf, Rrd, Ds, Wog, Wog, Wog^Qhux, Wog, Ds, Rrd, Ds
Gg, Gll, Gll^Fp, Gll, Gll^Fp, Gll, Gs, Re, Re, Gg, Gll, Gll^Fp, Gll^Fp, Gll^Fp, Gll^Fp, Gll^Fp, Gll, Gll^Em, Wwf, Wwf, Wog, Wog, Wog^Qhux, Wog^Qhux, Wog, Wog, Rrd, Rrd, Ds
Gg, Gll^Fp, Gll^Fp, Gll^Fp, Gll^Em, Gs, Gg, Re, Re, Gg, Gll^Fp, Gll^Fp, Gll^Fp, Gll^Emf, Gll^Fp, Gll^Fp, Gll, Gg, Gg, Ds, Wog, Wog, Wog, Wog^Qhux, Wog, Ds, Ds, Rd, Rrd
Gg, Gll^Fp, Gll^Fp, Gll^Fp, Gll, Gs, Gs, Re, Re, Gg, Gg, Gg, Gg, Gs, Gll^Fp, Gll^Em, Ds, Gg, Ds, Ds, Wog, Wog, Wog^Qhux, Wog^Qhux, Wog, Wwrg, Wwrg, Ds, Rrd
Gg, Gll^Fp, Gll, Gll^Em, Gg, Gs, Re, Re, Re, Gg, Gs, Gs, Gg, Gg, Gg, Gg, Gg, Ds, Wog, Wog, Rrd, Wog, Wog^Qhux, Wog^Qhux, Wog, Wog, Ds, Rd, Rrd
Gg, Gs, Gs, Gs, Gs, Gs, Re, Re, Ce, Gs, Gg, Gg, Gg, Gll^Fp, Gll^Fp, Gll^Fp, Wwrg, Wog, Wog, Ds, Wwrg, Wog, Wog, Wog, Wog, Wog, Ds, Rrd, Ds
Gg, Gg, Re, Gg, Re, Re, Re, Ce, 1 Ke, Ce, Gg, Gg, Gll^Fp, Gg, Gg, Wwrg, Wog, Wog, Rrd, Wog, Wog, Wog, Wog^Qhux, Wog^Qhux, Wog, Ds, Wwrg, Wwrg, Ds
Gg, Re, Gg, Re, Re, Re, Ce, Re, Ce, Gg, Gg, Gg, Gg, Gg, Wwrg, Gg, Wog, Ds, Rrd, Ds, Wog, Wog, Wog^Qhux, Wog^Qhux, Wog, Wog, Wog, Wog, Ds
Gg, Gg, Gg, Re, Gg, Ce, Gg, Re, Gg, Gg, Gg, Gg, Gg, Gg, Gg, Wog, Rrd, Ds, Rrd, Ds, Wog, Wog, Wog^Qhux, Wog^Qhux, Wog^Qhux, Wog, Wog, Wog, Gg
