Gg, Gg, Gll^Fp, Gg, Gll^Fp, Gll^Fp, Gll^Fp, Gll^Fp, Hhd^Fp, Gll^Fp, Gll^Fp, Gll^Fp, Gll^Fp, Gll^Fp, Gg, Gll^Fp, Gll^Fp, Gll^Fp, Gll^Fp, Gll^Fp, Gg^Efm, Gg, Gll^Fp, Gll^Fp, Gll^Fp, Gll^Fp, Wot, Gg, Gg
Gll^Fp, Gll^Fp, Gll^Fp, Gll^Vft5, Hhd^Fp, Gll^Fp, Gll^Fp, Gll^Fp, Hhd^Fp, Hhd^Fp, Gll^Fp, Gll^Fp, Gll^Fp, Gll^Fp, Aa^Fpa, Gll^Fp, Gll^Fp, Gll^Fp, Gll^Fp, Gll^Fp, Gll^Fp, Gll^Fmw, Gll^Fp, Gll^Fp, Wot, Wot, Wot, Gll^Fp, Gll^Fp
Gll^Fp, Gll^Fp, Gll^Fp, Hhd^Fp, Hhd^Fp, Aa^Fpa, Hhd^Fp, Gll^Fp, Hhd^Fp, Ww^Ewl, Gll^Fp, Gll^Fp, Gll^Fp, Gll^Fp, Hhd^Fp, Aa^Fpa, Gll^Fp, Gg, Hhd^Fp, Gll^Fmw, Gll^Fmw, Gll^Fp, Ww^Ewl, Gll^Fp, Wot, Wot, Aa^Fpa, Gll^Fp, Gll^Fp
Gll^Fp, Gll^Fp, Gll^Fp, Gll^Fp, Gll^Fp, Hhd^Fp, Hhd, Hhd^Fp, Gll^Fp, Gll^Fp, Ww^Ewl, Ww^Ewl, Gll^Fp, Hhd^Fp, Gll^Vft3, Gll^Fmw, Gll^Fmw, Gg^Efm, Gll^Fmw, Gll^Fmw, Hhd^Fp, Ww^Ewl, Gll^Fp, Wot, Wot, Aa^Fpa, Hhd^Fds, Gs^Fds, Gll^Fp
Gg, Gll^Fp, Ww^Ewl, Gll^Fmw, Gll^Fp, Gll^Fp, Gll^Fp, Gll^Fdf, Hhd^Fdf, Gll^Fp, Gll^Fp, Gll^Fp, Aa^Fpa, Hhd^Fp, Hhd^Fp, Gll^Fmw, Gll^Fmw, Gg^Efm, Gll^Fmw, Hhd^Fp, Hhd^Fdf, Gll^Fp, Gll^Fp, Wot, Gll^Fp, Aa^Fpa, Hhd^Fp, Gs^Fds, Gll^Fp
Gg, Gg, Gll^Fp, Gll^Fp, Gll^Fmw, Hhd^Fdf, Gs^Fds, Gll^Fdf, Gll^Fp, Gll^Fp, Gll^Fdf, Gll^Fdf, Gll^Fdf, Gll^Fp, Gll^Fmw, Gll^Fmw, Gg^Efm, Gll^Fp, Gg^Efm, Gll^Fp, Hhd^Fp, Wot, Wot, Wot, Gll^Vft2, Gll^Fdf, Hhd^Fdf, Gll^Fdf, Gll^Fp
Gg, Gll^Fp, Gll^Fp, Gll^Fp, Gll^Fmw, Gll^Fp, Gll^Fp, Gll^Fp, Gll^Fmw, Gll^Vft1, Gll^Fdf, Gll^Fp, Gll^Fmw, Gll^Fmw, Gg^Efm, Gg^Efm, Gll^Fp, Gll^Fp, Wot, Gll^Fdf, Wot, Wot, Wot, Gll^Fp, Aa^Fpa, Aa^Fpa, Hhd^Fds, Gll^Fdf, Gll^Fp
Gg, Gll^Fp, Gll^Fp, Gll^Fmw, Gll^Fmw, Gll^Fp, Gg, Gll^Fmw, Gll^Fp, Gll^Fmw, Gll^Fp, Gll^Fp, Gg^Efm, Gll^Fmw, Gll^Fp, Gll^Fp, Gll^Fp, Gll^Fdf, Gll^Fp, Wot, Wot, Ww^Ewl, Wot, Gll^Fdf, Gll^Fp, Gll^Fmw, Hhd^Fp, Gll^Fmw, Gll^Fp
Gg, Gll^Fp, Gll^Fp, Gll^Fmw, Gll^Fp, Gll^Fmw, Gg, Gll^Fmw, Gll^Fmw, Gll^Fp, Gs^Fds, Gll^Fmw, Gg^Efm, Gll^Fdw, Urb, Gll^Fp, Gs^Fds, Gll^Vft2, Gs^Fds, Gll^Fdf, Gll^Fdf, Wot, Gll^Fp, Aa^Fpa, Gs^Fds, Gll^Fdf, Hhd^Fp, Gll^Fp, Gll^Fdf
Gg^Efm, Gg^Efm, Gll^Fp, Gll^Fmw, Gll^Fp, Gll^Fp, Gs^Fds, Gll^Fmw, Gg, Gll^Fp, Gg^Efm, Gll^Fdw, Urb^Fdw, Urb, Urb^Fp, Urb^Fp, Aa^Fpa, Gs^Fds, Gs^Fdw, Gll^Fp, Gll^Fdf, Wot, Wot, Gll^Fmw, Aa^Fpa, Gll^Fp, Aa^Fpa, Hhd^Fp, Wot
Gg^Efm, Gll^Fmw, Gll^Fmw, Gll^Vft2, Gll^Fp, Gll^Fp, Gs^Fds, Gll^Fmw, Ur, Gs, Urb^Fp, Ur^Fdw, Isa, Isa, Isa, Urb^Fds, Urb, Gd^Fetd, Gll^Fdf, Gll^Fdw, Gs^Fds, Gll^Fp, Wot, Gs^Fds, Wot, Gll^Fp, Gll^Fdf, Wot, Gll^Fp
Gg, Gll^Fp, Gll^Fp, Gll^Fp, Gll^Fp, Gll^Fp, Gll^Fp, Gg, Ur, Urb^Feth, Gll^Fp, Isa^Fp, Gll^Fp, Gll^Fp, Isa, Isa, Isa^Fp, Urb^Fp, Urb^Feth, Ur, Urb^Fp, Wot, Gs^Fds, Wot, Wot, Wot, Gll^Fp, Gll^Fp, Gs^Fds
Gll^Fp, Gll^Fp, Gg, Gll^Fp, Gll^Fp, Gs^Fds, Ur, Gll^Fdw, Ur, Urb, Isa^Fp, Isa, Isa, Isa, Urb, Isa, Isa^Fp, Urb^Efm, Ur, Urb^Fp, Wot, Wot, Gll^Fp, Gll^Fp, Gs^Fds, Gll^Fp, Gll^Fp, Gs^Fds, Gs^Fds
Gg, Gg, Gll^Fp, Gs^Fds, Gg^Efm, Gg, Ur, Ur, Gll^Fp, Isa, Gll^Fp, Urb^Feth, Urb^Cov, Urb^Cov, Urb^Cov, Isa, Isa^Fp, Urb^Fp, Gll^Fp, Gg^Efm, Wot, Gll^Fp, Gll^Vft2, Gs^Fds, Gs^Fds, Gll^Fp, Gs^Fds, Gs^Fds, Wot
Gg, Gll^Fp, Gg, Gll^Fp, Gll^Fp, Ur, Gs, Ur, Gll^Fdw, Urb, Urb^Fp, Isa^Cov, Urb^Cov, Urb^Kov, Isa^Cov, Isa^Cov, Urb^Fp, Urb^Fp, Wot, Wot, Gll^Fp, Gll^Fp, Gll^Fp, Gll^Fp, Gll^Fp, Gs^Fds, Wot, Wot, Wot
Gg, Gg, Gll^Fp, Gll^Fp, Gg, Gg, Ur, Ur, Ur, Urb^Fp, Urb^Fp, Isa^Fdw, Isa, Isa^Cov, Isa, Urb^Feth, Urb^Fp, Urb^Fp, Wot, Gll^Fp, Gll^Fp, Gll^Fp, Gll^Fp, Gs^Fds, Wot, Gll^Fp, Wot, Wot, Wot
Gg, Gg, Gll^Fp, Gg, Gs, Gs, Ur, Urb, Gll^Fdw, Ur, Urb, Isa, Isa, Ur, Urb^Fp, Urb^Fp, Gll^Fdw, Wot, Urb, Wot, Gll^Fp, Gll^Fp, Gll^Fp, Gll^Fp, Wot, Gs^Fds, Wot, Wot, Wot
Gg, Gll^Fp, Gll^Fp, Gg, Gs, Gs, Urb, Gll^Fdw, Gll^Fdw, Urb, Ur, Urb^Fp, Ur, Isa^Efm, Ur, Ur, Wot, Gll^Fdw, Gg, Wot, Gll^Fp, Gll^Fp, Gll^Fp, Gll^Fp, Wot, Wot, Wot, Wot, Wot
Gg, Gll^Fp, Gg, Gs, Re, Re, Gs, Gll^Fdw, Gg, Ur, Ur, Ur, Ur, Urb, Urb, Ur, Urb, Urb, Gg, Wot, Wot, Gll^Fp, Wot, Wot, Wot, Wot, Wot, Wot, Wot
Gg, Gg, Gs, Gs, Re, Gg, Gs, Gll^Fp, Gll^Fp, Gg, Gg, Gg, Urb, Urb, Gll^Fp, Urb, Gll^Fdw, Gll^Fp, Gll^Fp, Wot, Wot, Ds, Wot, Wot, Wot, Wot, Wot, Wot, Wot
Gg, Gll^Fp, Gll^Fp, Re, Re, Gs, Gg, Gll^Fp, Gg, Gg, Gg, Gg^Efm, Gg, Gll^Fp, Gll^Fp, Gll^Fp, Gs, Gg, Wot, Wot, Wot, Gg, Wot, Wot, Wot, Wot, Wot, Wot, Gg
Gg, Gg, Gll^Fp, Re, Re, Gs, Gg, Gg, Gs, Gs, Gs, Gg, Gg, Gg, Gg, Gg, Gg, Gll^Fp, Gg, Gg, Ds, Ds, Wot, Wot, Wot, Wot, Wot, Gg, Gg
Gg, Gll^Fp, Gs, Gg, Gg, Gs, Gg, Gg, Gg, Gg, Gll^Fp, Gll^Fp, Gll^Fp, Gll^Fp, Gll^Fp, Gg, Gs^Efm, Gg, Gg, Gg, Ds, Wot, Wot, Wot, Wot, Wot, Gg, Gg, Gg
Gll^Fp, Gll^Fp, Gs, Gg, Gg, Gs, Gg, Gg, Gg, Gg, Gs, Gs, Gg, Gll^Fp, Gll^Fp, Gg, Gg^Efm, Gg^Efm, Gg, Ds, Wot, Wot, Wot, Wot, Wot, Wot, Gg, Gg, Wot
Gg, Gll^Fp, Gg, Gs, Gg, Re, Re, Gg, Gg, Gg, Gg, Gs, Gs, Gll^Fp, Gll^Fp, Gll^Fp, Gll^Fp, Gg^Efm, Wot, Gg, Ds, Wot, Wot, Wot, Wot, Wot, Wot, Wot, Gg
Gg, Gg, Gll^Fp, Gs, Gg, Re, Gg, Re, Re, Re, Gll^Fp, Gg, Gg, Gs, Gll^Fp, Gg, Wot, Wot, Wot, Gg, Wot, Wot, Wot, Wot, Wot, Wot, Ds, Ds, Gg
Gg, Gg, Gll^Fp, Gll^Fp, Gll^Fp, Gll^Fp, Gg, Gg, Re, Re, Gll^Fp, Gg, Gg, Gs, Gs, Gg, Gll^Fp, Gg, Gg, Wot, Gg, Gg, Wot, Wot, Wot, Wot, Ds, Gg, Gg
Gg, Gg, Gs, Gg, Gll^Fp, Gg, Gs, Gs, Re, Re, Gg, Gll^Fp, Gg, Gll^Fp, Gll^Fp, Gg, Gll^Fp, Gg, Gg, Wot, Gg, Ds, Wot, Wot, Wot, Wot, Ds, Gg, Gg
Gg, Gg, Gll^Fp, Gg, Gll^Fp, Gg, Gs, Re, Re, Gg, Gs, Gll^Fp, Gll^Fp, Gll^Fp, Gll^Fp, Gll^Fp, Gg, Gg, Wot, Wot, Wot, Wot, Wot, Wot, Wot, Wot, Gg, Gg, Re
Gg, Gll^Fp, Gll^Fp, Gll^Fp, Gg, Gs, Gg, Re, Re, Gg, Gll^Fp, Gll^Fp, Gll^Fp, Gg, Gll^Fp, Gll^Fp, Gg, Gg, Gg, Ds, Wot, Wot, Wot, Wot, Wot, Ds, Ds, Gg, Gg
Gg, Gll^Fp, Gll^Fp, Gll^Fp, Gg, Gs, Gs, Re, Re, Gg, Gg, Gg, Gg, Gs, Gll^Fp, Gg, Ds, Gg, Ds, Ds, Wot, Wot, Wot, Wot, Wot, Wot, Wot, Ds, Gg
Gg, Gll^Fp, Gg, Gg, Gg, Gs, Re, Re, Re, Gg, Gs, Gs, Gg, Gg, Gg, Gg, Gg, Ds, Wot, Wot, Gg, Wot, Wot, Wot, Wot, Wot, Ds, Gg, Gg
Gg, Gs, Gs, Gs, Gs, Gs, Re, Re, Ce, Gs, Gg, Gg, Gg, Gll^Fp, Gll^Fp, Gll^Fp, Wot, Wot, Wot, Ds, Wot, Wot, Wot, Wot, Wot, Wot, Ds, Gg, Gg
Gg, Gg, Re, Gg, Re, Re, Re, Ce, Ke, Ce, Gg, Gg, Gll^Fp, Gg, Gg, Wot, Wot, Wot, Gg, Wot, Wot, Wot, Wot, Wot, Wot, Ds, Wot, Wot, Gg
Gg, Re, Gg, Re, Re, Re, Ce, Re, Ce, Gg, Gg, Gg, Gg, Gg, Wot, Gg, Wot, Ds, Gg, Ds, Wot, Wot, Wot, Wot, Wot, Wot, Wot, Wot, Gg
Gg, Gg, Gg, Re, Gg, Ce, Gg, Re, Gg, Gg, Gg, Gg, Gg, Gg, Gg, Wot, Gg, Ds, Gg, Ds, Wot, Wot, Wot, Wot, Wot, Wot, Wot, Wot, Gg
