Gg, Gg, Gg, Gg, Gg, Gg, Gll^Fmf, Rb, Gll^Fmf, Rb, Gll^Fmf, Gg, Gll^Fmf, Gg, Chr, Gg, Gg, Gg, Chr^Qov, Gg, Chr^Qov, Gg, Rrc, Gg, Rrc, Gll^Fmf, Gg, Rrc, Chr, Gll^Fmf, Gg, Gll^Fp, Gg, Gll^Fp, Chr, Gll^Fp, Gg, Wo, Wo, Wo, Wo, Wwt, Wo, Wwt, Wo, Gg, Gg, Gg, Gg, Gg, Gll^Fmf, Gg, Gll^Fmf, Gg, Gll^Fmf
Gg, Gg, 1 Ke, Rb, Gg, Gll^Fmf, Gg, Gll^Fmf, Gll^Fmf, Gll^Fmf, Gll^Fmf, Gll^Fmf, Chr, Chr, Gll^Fmf, Gll^Fmf, Gll^Fmf, Chr^Qov, Rrc, Rrc, Isa^Dr, Rrc, Isa^Dr, Rrc, Gll^Fmf, Chr, Chr, Chr, Rb, Chr, Rp^Vhcr, Chr, Chr, Chr, Gll^Fp, Chr, Ds, Wwt, Wo, Wo, Wo, Wo, Wo, Wo, Chr, Wo, Chr, Gg, Chr, Gll^Fmf, Gll^Fmf, Gll^Fmf, Gll^Fmf, Gll^Fmf, Gll^Fmf
Gg, Rb, Ce, Ce, Rb, Gg, Gll^Fmf, Gll^Fmf, Chr, Chr, Gll^Fmf, Gll^Fmf, Chr, Chr, Rrc, Gll^Fmf, Chr^Qov, Chr^Qov, Rp^Vhcr, Rrc, Gll^Fmf, Isa^Dr, Gll^Fmf, Chr^Qov, Chr^Qov, Chr, Gll^Fmf, Gll^Fmf, Gll^Fmf, Rrc, Rp^Vhcr, Gll^Fmf, Rrc, Rp^Vhcr, Chr, Chr, Wwt, Wwt, Wo, Wo, Wo, Wo, Wo, Wo, Chr, Gll^Fmf, Gg, Chr, Gg, Chr, Chr, Gll^Fmf, Gll^Fmf, Gll^Fmf, Gg
Gg, Ce, Gg, Ce, Gg, Rb, Rb, Gll^Fmf, Chr, Gll^Fmf, Isa, Gll^Fmf, Chr, Chr, Isa^Dr, Gll^Fmf, Chr^Qov, Gll^Fmf, Rp^Vhcr, Chr, Chr^Qov, Chr^Qov, Chr^Qov, Rrc, Rrc, Rrc, Chr, Gll^Fmf, Gll^Fmf, Rrc, Gll^Fmf, Wwt, Chr, Chr, Wwt, Wwt, Wwt, Wo, Wo, Wo, Gg, Gll^Fp, Chr, Wo, Chr, Gll^Fmf, Rp^Vhcr, Rp^Vhcr, Rp^Vhcr, Chr, Gg, Chr, Chr, Gll^Fmf, Gg
Gg, Gg, Gg, Gg, Gg, Gg, Rb, Rb, Isa, Isa, Gg, Chr, Isa^Dr, Isa^Dr, Isa^Dr, Chr^Qov, Gll^Fmf, Chr, Chr, Isa^Dr, Rrc, Chr, Chr, Chr, Rp^Vhcr, Rp^Vhcr, Gd^Fetd, Chr, Chr^Qov, Chr^Qov, Chr, Wo, Wo, Wwt, Wwt, Wo, Wo, Wo, Rb, Gg, Wo, Chr, Gll^Fp, Chr, Gll^Fmf, Gll^Fmf, Rp^Vhcr, Rp^Vhcr, Chr, Gg, Gg, Gg, Chr, Gll^Fmf, Gg
Gg, Gll^Fmf, Gll^Fmf, Gll^Fmf, Gll^Fmf, Gll^Fmf, Chr, Rb, Isa, Chr, Chr, Isa, Gll^Fmf, Isa, Isa, Isa^Dr, Chr, Chr, Rrc, Isa^Dr, Rp^Vhcr, Isa^Dr, Rp^Vhcr, Rp^Vhcr, Rrc, Chr, Isa, Isa, Chr, Chr^Qov, Rb, Wwt, Wo, Wo, Wo, Wo, Wo, Wo, Wo, Wwt, Wwt, Chr, Gll^Fp, Gll^Fmf, Gll^Fp, Gll^Fmf, Rp^Vhcr, Chr, Chr, Chr, Chr, Rp^Vhcr, Gll^Fmf, Chr, Gg
Gg, Gll^Fmf, Gll^Fmf, Gll^Fmf, Chr, Chr, Isa^Dr, Gll^Fmf, Chr, Gll^Fmf, Rp^Vhcr, Gll^Fmf, Isa^Dr, Chr^Qov, Isa^Dr, Isa^Dr, Rrc, Isa, Rp^Vhcr, Rp^Vhcr, Chr, Isa^Dr, Rp^Vhcr, Isa, Chr, Chr, Isa, Chr^Qov, Chr^Qov, Ds, Wwt, Wo, Wo, Wo, Wo, Wo, Wo, Wo, Chr, Wwt, Chr, Chr, Chr, Gll^Fmf, Rp^Vhcr, Rp^Vhcr, Chr, Gg, Chr, Isa^Dr, Chr, Gg, Gll^Fmf, Chr, Chr
Gg, Gll^Fmf, Gll^Fmf, Chr, Chr, Isa^Dr, Rrc, Rrc, Rp^Vhcr, Chr, Gll^Fmf, Gd^Fetd, Rp^Vhcr, Chr^Qov, Isa^Dr, Rp^Vhcr, Chr, Isa, Isa^Dr, Isa^Dr, Chr, Isa, Isa, Rp^Vhcr, Isa, Rrc, Chr, Isa, Wwt, Wwt, Wwt, Wo, Wo, Wo, Wo, Wwt, Wo, Gg, Chr, Chr, Isa, Rp^Vhcr, Gll^Fdf, Chr, Rp^Vhcr, Gll^Fmf, Rp^Vhcr, Chr, Isa^Dr, Isa^Dr, Gg, Rp^Vhcr, Rp^Vhcr, Chr, Gg
Gg, Gll^Fmf, Gll^Fmf, Gll^Fmf, Rp^Vhcr, Gll^Fmf, Rrc, Gll^Fmf, Rp^Vhcr, Isa, Chr, Isa^Dr, Chr^Qov, Chr^Qov, Rp^Vhcr, Rp^Vhcr, Rp^Vhcr, Rp^Vhcr, Chr^Qov, Isa^Dr, Rp^Vhcr, Isa, Rp^Vhcr, Rp^Vhcr, Isa, Isa, Chr^Qov, Chr^Qov, Wwt, Wo, Wo, Wo, Wo, Wo, Wwt, Rb, Wwt, Chr, Gll^Fmf, Gll^Fmf, Gll^Fmf, Isa, Isa, Gll^Fdf, Gll^Fmf, Isa, Isa, Isa, Isa, Isa^Dr, Gg, Gg, Rp^Vhcr, Chr, Chr
Gg, Gll^Fmf, Chr, Chr, Gll^Fmf, Isa^Dr, Rrc, Rp^Vhcr, Chr, Chr, Chr^Qov, Chr^Qov, Chr^Qov, Chr, Rp^Vhcr, Chr, Gg, Rp^Vhcr, Rp^Vhcr, Wwt, Isa, Isa, Rp, Isa, Rp^Dr, Chr^Qov, Chr^Qov, Wwt, Wo, Wo, Wo, Wo, Wo, Wo, Wwt, Wwt, Chr^Qov, Chr^Qov, Chr^Qov, Chr^Qov, Chr^Qov, Chr^Qov, Chr^Qov, Chr^Qov, Isa, Isa, Rp^Vhcr, Rp^Vhcr, Rp, Rp, Isa^Dr, Rp^Vhcr, Isa, Chr, Chr
Gg, Chr, Gll^Fmf, Chr, Isa^Dr, Rrc, Isa, Isa, Isa, Rb, Chr^Qov, Rp^Vhcr, Rp^Vhcr, Isa, Chr, Chr, Gd^Fetd, Rp^Vhcr, Isa, Rp^Vhcr, Isa^Dr, Rp, Isa^Dr, Isa, Rp, Rp, Wwt, Wo, Wo, Wo, Wo, Wwt, Wo, Rb, Wwt, Chr^Qov, Chr^Qov, Chr, Chr, Isa, Isa, Isa^Dr, Chr, Chr^Qov, Isa, Rp^Vhcr, Chr, Rp, Isa, Isa^Dr, Rp, Gg, Chr, Chr, Chr
Chr, Chr, Rp^Vhcr, Isa^Dr, Isa, Chr, Chr, Chr, Chr, Rb^Qov, Chr^Qov, Rp^Vhcr, Isa, Isa, Isa, Isa, Rrc, Chr, Chr, Chr, Rp, Chr^Qov, Chr^Qov, Rp, Wwt^Bsb\, Wwt^Bsb\, Wo^Bsb\, Wo^Bsb\, Wo, Wwt, Wo, Gg, Wwt, Wwt, Ds^Qov, Isa^Dr, Isa^Dr, Gd^Fetd, Rp^Vhcr, Rp^Vhcr, Gd^Fetd, Isa^Dr, Rrc, Chr^Qov, Gll^Fmf, Rp^Vhcr, Chr, Isa, Isa, Chr, Chr, Rp^Vhcr, Chr, Rp^Vhcr, Gg
Chr, Chr, Chr, Isa, Isa, Isa, Chr, Gg, Isa, Isa^Dr, Isa^Dr, Isa^Dr, Rp^Vhcr, Rp^Vhcr, Rp^Vhcr, Rp^Vhcr, Rp^Vhcr, Chr, Chr, Rrc, Rb, Chr^Qov, Wwt, Wwt, Wo, Wo^Bsb\, Wo^Bsb\, Wo^Bsb\, Wwt^Bsb\, Wwt^Bsb\, Wwt, Wwt, Ds, Ds, Chr^Qov, Isa^Dr, Isa, Rp^Vhcr, Rp^Vhcr, Chr, Rp^Vhcr, Chr, Chr, Chr^Qov, Isa^Dr, Isa^Dr, Gg, Chr, Isa^Dr, Isa, Rp, Chr, Isa, Chr, Chr
Chr, Rrc, Isa, Isa, Isa, Gd^Fetd, Rp^Vhcr, Rp^Vhcr, Isa, Isa^Dr, Chr^Qov, Isa^Dr, Rp^Vhcr, Isa, Chr, Rp^Vhcr, Rrc, Rrc, Rrc, Chr^Qov, Rrc^Qov, Chr^Qov, Wo, Wo, Wo, Wo, Wo, Wo^Bsb\, Rp, Isa, Isa, Isa, Chr^Qov, Chr^Qov, Chr^Qov, Rp^Vhcr, Rp^Vhcr, Chr, Rp^Vhcr, Isa^Dr, Isa, Isa^Dr, Chr^Qov, Isa, Isa^Dr, Chr, Chr, Chr, Rp^Vhcr, Isa, Isa, Isa, Isa, Isa, Chr
Chr, Rrc, Isa, Isa, Rp^Vhcr, Chr, Gg, Chr, Isa, Chr^Qov, Chr^Qov, Rp^Vhcr, Rp^Vhcr, Isa, Isa, Chr^Qov, Chr^Qov, Chr^Qov, Chr^Qov, Ds, Wo, Ds, Wo, Wo, Wo, Wo, Wo, Wwt, Isa, Isa, Gg, Isa, Isa, Isa, Rrc, Isa^Dr, Isa^Dr, Chr, Isa, Isa^Dr, Rp^Vhcr, Chr^Qov, Chr^Qov, Isa, Gll^Fmf, Chr, Isa^Dr, Rp^Vhcr, Isa, Isa, Chr, Isa, Rp^Vhcr, Isa, Chr
Gg, Chr, Isa, Rp^Vhcr, Chr, Isa, Isa^Dr, Isa^Dr, Isa, Chr^Qov, Rrc, Gd^Fetd, Rp^Vhcr, Rrc, Rp^Vhcr, Ds^Qov, Wwt, Wwt, Wwt, Wo, Wo, Wwt, Wo, Wo, Wo, Wwt, Rb, Chr^Qov, Chr^Qov, Rp^Vhcr, Rrc, Chr, Rp^Vhcr, Rp^Vhcr, Isa, Isa, Isa^Dr, Rp^Vhcr, Chr, Rp^Vhcr, Chr, Chr^Qov, Isa, Isa, Isa, Isa^Dr, Isa^Dr, Isa, Rp^Vhcr, Rp^Vhcr, Chr, Chr, Chr, Chr, Gll^Fmf
Chr, Gg, Isa, Isa^Dr, Isa, Chr, Isa^Dr, Chr, Chr, Chr^Qov, Rrc, Rp^Vhcr, Rp^Vhcr, Chr, Chr, Chr^Qov, Wo, Wwt, Wo, Wo, Wo, Wo, Wo, Wo, Wwt, Wwt, Chr^Qov, Isa, Chr, Rp^Vhcr, Rrc, Rp^Vhcr, Chr, Rp^Vhcr, Isa^Dr, Rp^Vhcr, Isa^Dr, Isa, Isa, Chr, Chr^Qov, Isa, Chr, Gll^Fmf, Chr, Chr, Isa, Isa, Chr, Isa^Dr, Chr, Gll^Fmf, Gll^Fmf, Gll^Fmf, Gll^Fmf
Chr, Rp^Vhcr, Isa, Rp^Vhcr, Chr, Chr, Isa^Dr, Rp^Vhcr, Isa, Gll^Fmf, Chr^Qov, Chr^Qov, Chr^Qov, Chr^Qov, Wwt^Qov, Wo, Wo, Wo, Wo, Wo, Wo, Wo, Wo, Wo, Ds, Chr^Qov, Chr^Qov, Isa, Rp^Vhcr, Rrc, Isa^Dr, Rp^Vhcr, Isa^Dr, Rrc, Chr, Rp^Vhcr, Chr, Rp^Vhcr, Isa, Isa, Isa, Isa, Chr, Rp^Vhcr, Isa, Rp^Vhcr, Isa, Isa, Isa, Isa^Dr, Rp^Vhcr, Rp^Vhcr, Gll^Fmf, Gll^Fmf, Gll^Fmf
Rp, Rp, Isa^Dr, Isa, Rp^Vhcr, Gll^Fmf, Isa, Isa, Rp, Isa^Dr, Chr^Qov, Rb^Qov, Wo, Wo, Wo, Wo, Wo, Wo, Wo, Wo, Wo, Wo, Wo, Wo, Ds^Qov, Chr, Isa^Dr, Rrc, Isa, Rrc, Rrc, Isa^Dr, Rp^Vhcr, Rrc, Chr, Chr, Rrc, Rrc, Rp^Vhcr, Chr^Qov, Isa^Dr, Isa, Isa, Isa, Gll^Fmf, Isa, Rp^Vhcr, Isa, Isa, Rp, Rp, Gll^Fmf, Rb, Gll^Fmf, Rb
Isa, Isa, Isa^Dr, Isa, Isa, Isa, Chr, Rp^Vhcr, Chr, Chr, Gll^Fmf, Wo, Wo, Wo, Wo, Wo, Wo, Wo, Wo, Wo, Wo, Wo, Wo, Ds, Chr, Chr, Rrc, Chr^Qov, Chr, Rp^Vhcr, Isa, Rp^Vhcr, Rp^Vhcr, Chr, Chr, Rrc, Chr, Chr^Qov, Chr^Qov, Gll^Fmf, Isa^Dr, Isa^Dr, Chr, Chr, Isa, Isa, Chr, Isa, Gll^Fmf, Gll^Fmf, Gll^Fmf, Rp, Isa, Rb, Gg
Rp, Isa^Dr, Rp^Vhcr, Isa, Isa, Isa^Dr, Isa^Dr, Isa^Dr, Gll^Fmf, Chr, Chr^Qov, Wwt, Wo, Wo, Wo, Wo, Wwt, Wwt, Chr, Chr, Chr, Chr, Chr, Chr, Gll^Fmf, Rrc, Chr, Chr, Rrc, Chr^Qov, Isa, Chr, Isa, Chr, Rrc, Chr^Qov, Chr^Qov, Gll^Fmf, Gd^Fetd, Chr, Chr, Isa, Isa, Isa, Isa, Chr, Rp^Vhcr, Chr, Gll^Fmf, Gll^Fmf, Gll^Fmf, Rb, Rb, Gg, Gg
Rp, Isa, Chr, Chr, Chr, Rp^Vhcr, Chr, Gg, Chr, Gll^Fmf, Chr^Qov, Wo, Wo, Wo, Wo, Wo, Wwt, Gll^Fmf, Chr, Gll^Fmf, Chr, Gll^Fmf, Rp^Vhcr, Isa^Dr, Gll^Fmf, Rp^Vhcr, Chr, Gll^Fmf, Gll^Fmf, Gll^Fmf, Chr^Qov, Isa^Qov, Chr, Chr^Qov, Rrc, Chr^Qov, Gll^Fmf, Rp^Vhcr, Chr, Chr, Rp^Vhcr, Isa, Rp^Vhcr, Chr, Chr, Gll^Fmf, Gll^Fmf, Chr, Gll^Fmf, Isa, Isa, Rb, Rb, Rb, Gg
Gg, Rp, Gg, Chr, Gg, Chr, Gg, Chr, Gg, Chr, Wwt, Wwt, Wo, Wwt, Wo, Wo, Gll^Fmf, Chr, Gll^Fmf, Gg, Gg, Gg, Gg, Gg, Gll^Fmf, Chr, Gd^Fetd, Gg, Gll^Fmf, Gg, Gll^Fmf, Gg, Chr^Qov, Gg, Chr, Gg, Gll^Fmf, Gg, Gll^Fmf, Gll^Fmf, Gll^Fmf, Gll^Fmf, Gll^Fmf, Gg, Rb, Chr, Gg, Gll^Fmf, Gg, Gll^Fmf, Gll^Fmf, Gll^Fmf, Gll^Fmf, Rb, Gg
