Rb, Rb, Rb, Gg, Gg, Gg, Gg, Gg, Gg, Gg, Gg, Gg, Gg, Gg, Gg, Gg, Gg, Gg, Gll^Fmf, Gg, Rrc, Gg, Gll^Fmf, Gg, Gll^Fp, Gg, Gll^Fp, Gg, Gll^Fp, Gg, Wo, Wo, Wo, Wo, Wwt, Wwt, Wwt, Gg, Gg, Gg
Gg, Rb, Rb, Rb, 1 Ke, Ce, Gg, Gg, Gg, Gg, Gll^Fmf, Gg, Gll^Fmf, Gg, Gll^Fmf, Gg, Gll^Fmf, Gll^Fmf, Chr^Qov, Gll^Fmf, Rb, Rb, Gll^Fmf, Gll^Fmf, Gll^Fmf, Gll^Fp, Gll^Fmf, Gll^Fp, Gll^Fp, Ds, Wwt, Wo, Wo, Wo, Wo, Wwt, Wwt, Gll^Fmf, Gll^Fmf, Gg
Gg, Gg, Gg, Ce, Ce, Ce, Rb, Gg, Gll^Fmf, Gll^Fmf, Gll^Fmf, Gll^Fmf, Rrc, Gll^Fmf, Chr^Qov, Gll^Fmf, Chr^Qov, Chr^Qov, Chr, Chr^Qov, Chr^Qov, Gll^Fmf, Gll^Fmf, Rb, Gll^Fmf, Gll^Fmf, Gll^Fmf, Ds, Ds, Wwt, Wwt, Wo, Wo, Wo, Rb, Wwt, Wwt, Gll^Fmf, Gll^Fmf, Gg
Gg, Gg, Gll^Fmf, Gg, Gll^Fmf, Rb, Isa, Rb, Gll^Fmf, Gll^Fmf, Gll^Fmf, Gll^Fmf, Chr^Qov, Chr^Qov, Rrc, Chr^Qov, Rrc, Rrc, Rrc, Chr, Chr^Qov, Gll^Fmf, Rb, Gll^Fmf, Wwt, Rb, Rb, Wwt, Wwt, Wwt, Wo, Wo, Wo, Gg, Gll^Fp, Gg, Wwt, Gll^Fmf, Gll^Fmf, Gg
Rb, Gg, Gll^Fmf, Gll^Fmf, Gll^Fmf, Rb, Isa, Isa, Chr^Qov, Gll^Fmf, Chr^Qov, Chr^Qov, Rrc, Rrc, Chr, Chr, Chr, Rp^Vhcr, Rp^Vhcr, Gd^Fetd, Chr, Chr^Qov, Chr^Qov, Gll^Fmf, Gg, Wwt, Wwt, Wwt, Wo, Wo, Wo, Rb, Gg, Wo, Gll^Fp, Gll^Fp, Wwt, Gll^Fmf, Gll^Fmf, Gg
Gg, Gg, Gll^Fmf, Gll^Fmf, Gll^Fmf, Gll^Fmf, Isa, Isa, Isa, Chr^Qov, Chr^Qov, Rrc, Gg, Rp^Vhcr, Rp^Vhcr, Rp^Vhcr, Rp^Vhcr, Rrc, Chr, Isa, Isa, Chr, Chr^Qov, Rb, Wwt, Wwt, Wo, Wo, Wo, Wo, Wo, Wo, Wwt, Wwt, Ds, Gll^Fp, Gll^Fmf, Gll^Fp, Gll^Fmf, Gg
Gll^Fmf, Gg, Gll^Fmf, Gg, Gll^Fmf, Gll^Fmf, Chr^Qov, Isa, Isa, Rrc, Isa, Rp^Vhcr, Rp^Vhcr, Chr, Isa, Rp^Vhcr, Chr, Chr, Chr, Isa, Chr^Qov, Chr^Qov, Ds, Wwt, Wwt, Wo, Wo, Wo, Wo, Wo, Wo, Wwt, Wwt, Wwt, Wwt, Ds, Gll^Fmf, Gll^Fmf, Gll^Fmf, Gg
Gg, Gll^Fmf, Gll^Fmf, Gll^Fmf, Gd^Fetd, Gll^Fmf, Chr^Qov, Gg, Rp^Vhcr, Isa, Isa, Isa, Isa, Chr, Isa, Isa, Rp^Vhcr, Isa, Rrc, Chr, Chr^Qov, Wwt, Wwt, Wwt, Wo, Wo, Wo, Wo, Wwt, Wo, Wwt, Gg, Gll^Fdf, Ds, Ds, Gll^Fdf, Gll^Fmf, Gll^Fmf, Gll^Fmf, Gg
Gll^Fmf, Gll^Fmf, Gll^Fmf, Gll^Fmf, Rb, Rb, Chr^Qov, Rp^Vhcr, Rp^Vhcr, Rp^Vhcr, Rp^Vhcr, Isa, Isa, Rp^Vhcr, Isa, Rp^Vhcr, Rp^Vhcr, Isa, Isa, Chr, Chr^Qov, Wwt, Wo, Wo, Wo, Wo, Wo, Wwt, Rb, Wwt, Rb, Gll^Fmf, Gll^Fmf, Gll^Fmf, Gll^Fdf, Gll^Fmf, Gll^Fdf, Gll^Fmf, Gll^Fmf, Gg
Gll^Fmf, Gll^Fmf, Rb, Chr^Qov, Chr^Qov, Chr^Qov, Chr, Rp^Vhcr, Chr, Gg, Rp^Vhcr, Rp^Vhcr, Wwt, Isa, Isa, Rp^Vhcr, Isa, Rp^Vhcr, Chr^Qov, Chr^Qov, Wwt, Wo, Wo, Wo, Wo, Wo, Wo, Wwt, Wwt, Chr^Qov, Chr^Qov, Chr^Qov, Chr^Qov, Chr^Qov, Chr^Qov, Chr^Qov, Chr^Qov, Gll^Fmf, Gll^Fmf, Gg
Gg, Gll^Fmf, Rb, Chr^Qov, Rp^Vhcr, Rp^Vhcr, Isa, Chr, Chr, Gd^Fetd, Rp^Vhcr, Isa, Rp^Vhcr, Isa, Rp, Isa, Isa, Rp^Vhcr, Rp, Wwt, Wo, Wo, Wo, Wo, Wwt, Wo, Rb, Wwt, Chr^Qov, Chr^Qov, Chr, Chr, Isa, Isa, Rrc, Chr, Chr^Qov, Gll^Fmf, Gll^Fmf, Gg
Gll^Qov, Gll^Fmf, Rb^Qov, Chr^Qov, Rp^Vhcr, Isa, Isa, Isa, Isa, Rrc, Chr, Chr, Chr, Rp, Chr^Qov, Chr^Qov, Rp, Wwt^Bsb\, Wwt^Bsb\, Wo^Bsb\, Wo^Bsb\, Wo, Wwt, Wo, Gg, Wwt, Wwt, Ds^Qov, Isa, Isa, Gd^Fetd, Rp^Vhcr, Rp^Vhcr, Gd^Fetd, Isa, Rrc, Chr^Qov, Gll^Fmf, Gll^Fmf, Gg
Gg, Gll^Qov, Gll^Fmf, Chr^Qov, Rrc, Rp^Vhcr, Rp^Vhcr, Rp^Vhcr, Rp^Vhcr, Rp^Vhcr, Chr, Chr, Rrc, Rb, Chr^Qov, Wwt, Wwt, Wo^Bsb\, Wo^Bsb\, Wo^Bsb\, Wo^Bsb\, Wwt^Bsb\, Wwt^Bsb\, Wwt, Wwt, Ds, Ds, Chr^Qov, Isa, Isa, Rp^Vhcr, Rp^Vhcr, Chr, Rp^Vhcr, Chr, Chr, Chr^Qov, Gll^Fmf, Gll^Fmf, Gg
Gg, Gll^Fmf, Gll^Fmf, Chr^Qov, Rrc, Rp^Vhcr, Isa, Chr, Rp^Vhcr, Rrc, Rrc, Rrc, Chr^Qov, Rrc^Qov, Chr^Qov, Wwt, Wo, Wo, Wo, Wo^Bsb\, Wo^Bsb\, Rp, Isa, Isa, Isa, Chr^Qov, Chr^Qov, Chr^Qov, Rp^Vhcr, Rp^Vhcr, Chr, Rp^Vhcr, Rp^Vhcr, Isa, Isa, Chr^Qov, Gll^Fmf, Gll^Fmf, Gll^Fmf, Gg
Gg, Gll^Fmf, Chr^Qov, Chr^Qov, Rp^Vhcr, Rp^Vhcr, Isa, Isa, Chr^Qov, Chr^Qov, Chr^Qov, Chr^Qov, Ds, Wwt, Ds, Wwt, Wo, Wo, Wo, Wo, Wwt, Isa, Isa, Gg, Isa, Isa, Isa, Rrc, Rrc, Rp^Vhcr, Chr, Isa, Chr, Rp^Vhcr, Chr^Qov, Chr^Qov, Gll^Fmf, Gll^Fmf, Gll^Fmf, Gg
Gg, Chr^Qov, Chr^Qov, Rrc, Gd^Fetd, Rp^Vhcr, Rrc, Rp^Vhcr, Ds^Qov, Wwt, Wwt, Wwt, Wwt, Wo, Wwt, Wo, Wo, Wo, Wwt, Rb, Chr^Qov, Chr^Qov, Rp^Vhcr, Rrc, Chr, Rp^Vhcr, Rp^Vhcr, Isa, Isa, Isa, Isa, Isa, Rp^Vhcr, Chr, Chr^Qov, Gll^Fmf, Gll^Fmf, Gll^Fmf, Gg, Gg
Gg, Chr^Qov, Chr^Qov, Rrc, Rp^Vhcr, Rp^Vhcr, Chr, Chr, Chr^Qov, Wwt, Wwt, Wo, Wo, Wo, Wo, Wo, Wo, Wwt, Wwt, Chr^Qov, Isa, Chr, Rp^Vhcr, Rp^Vhcr, Rp^Vhcr, Chr, Rp^Vhcr, Isa, Rp^Vhcr, Isa, Isa, Isa, Isa, Chr^Qov, Gll^Fmf, Gll^Fmf, Gll^Fmf, Gll^Fmf, Gll^Fmf, Gll^Fmf
Gg, Gg, Gll^Fmf, Chr^Qov, Chr^Qov, Chr^Qov, Chr^Qov, Wwt^Qov, Wwt, Wo, Wo, Wo, Wo, Wo, Wo, Wo, Wwt, Ds, Chr^Qov, Chr^Qov, Isa, Rp^Vhcr, Rrc, Rrc, Rp^Vhcr, Rp^Vhcr, Rrc, Chr, Rp^Vhcr, Isa, Rp^Vhcr, Isa, Isa, Isa, Gll^Fmf, Gll^Fmf, Gll^Fmf, Gll^Fmf, Gll^Fmf, Gll^Fmf
Gg, Gg, Gll^Fmf, Gll^Fmf, Rb^Qov, Wwt, Wwt, Wo, Wo, Wo, Wo, Wo, Wo, Wo, Wo, Wwt, Wwt, Ds^Qov, Chr, Gg, Rrc, Isa, Chr, Chr, Isa, Rp^Vhcr, Rrc, Chr, Rrc, Rrc, Rrc, Rp^Vhcr, Chr^Qov, Isa, Isa, Gll^Fmf, Gll^Fmf, Gll^Fmf, Gll^Fmf, Gll^Fmf
Gg, Gll^Fmf, Gll^Fmf, Gll^Fmf, Wwt, Wwt, Wo, Wo, Wo, Wo, Wo, Wwt, Wwt, Wwt, Wwt, Ds, Ds, Chr^Qov, Chr^Qov, Rrc, Rrc, Chr, Isa, Isa, Rp^Vhcr, Rp^Vhcr, Chr, Chr, Rrc, Chr, Chr^Qov, Chr^Qov, Gll^Fmf, Gg, Gg, Rb, Gll^Fmf, Gll^Fmf, Gg, Gll^Fmf
Gg, Gll^Fmf, Gll^Fmf, Gll^Fmf, Wwt, Wo, Wo, Wo, Wo, Wwt, Wwt, Gg, Ds, Rb, Gll^Fmf, Gll^Fmf, Gll^Fmf, Gll^Fmf, Chr^Qov, Chr^Qov, Chr^Qov, Chr^Qov, Chr^Qov, Isa, Chr, Isa, Chr, Rrc, Chr^Qov, Chr^Qov, Gll^Fmf, Gd^Fetd, Gll^Fmf, Gll^Fmf, Gg, Rb, Rb, Gg, Gg, Gll^Fmf
Gg, Gll^Fmf, Gll^Fmf, Wwt, Wo, Wo, Wo, Wo, Wo, Wwt, Gll^Fmf, Gg, Gll^Fmf, Gll^Fmf, Gll^Fmf, Gll^Fmf, Gll^Fmf, Gll^Fmf, Gll^Fmf, Gll^Fmf, Gll^Fmf, Gll^Fmf, Gll^Fmf, Chr^Qov, Isa^Qov, Chr, Chr^Qov, Rrc, Chr^Qov, Gll^Fmf, Gll^Fmf, Gll^Fmf, Gll^Fmf, Gll^Fmf, Gll^Fmf, Gg, Gg, Rb, Rb, Gg
Gg, Gg, Gg, Wwt, Wwt, Wo, Wwt, Wo, Wo, Gll^Fmf, Wwt, Gll^Fmf, Gg, Gg, Gg, Gg, Gg, Gll^Fmf, Gg, Gd^Fetd, Gg, Gll^Fmf, Gg, Gll^Fmf, Gg, Chr^Qov, Gg, Chr, Gg, Gll^Fmf, Gg, Gll^Fmf, Gll^Fmf, Gll^Fmf, Gll^Fmf, Gll^Fmf, Gg, Rb, Gg, Gg
