Rb, Rb, Rb, Gg, Gg, Gg, Gg, Gg, Gg, Gg, Gg, Gg, Gg, Gg, Gg, Gg, Gg, Gg, Gll^Fmf, Gg, Rrc, Gg, Gll^Fmf, Gg, Gll^Fp, Gg, Gll^Fp, Gg, Gll^Fp, Gg, Wwt, Wwt, Wwt, Wo, Wwt, Wwt, Wwt, Gg, Gg, Gg
Gg, Rb, Rb, Rb, Ke, Ce, Gg, Gg, Gg, Gg, Gll^Fmf, Gg, Gll^Fmf, Gg, Gll^Fmf, Gg, Gll^Fmf, Gll^Fmf, Chr, Gll^Fmf, Rb, Rb, Gll^Fmf, Gll^Fmf, Gll^Fmf, Gll^Fp, Gll^Fmf, Gll^Fp, Gll^Fp, Ds, Wwt, Wo, Wo, Wwt, Wo, Wwt, Wwt, Gll^Fmf, Gll^Fmf, Gg
Gg, Gg, Gg, Ce, Ce, Ce, Rb, Gg, Gll^Fmf, Gll^Fmf, Gll^Fmf, Gll^Fmf, Rrc, Gll^Fmf, Chr, Gll^Fmf, Chr, Chr, Chr, Chr, Chr, Gll^Fmf, Gll^Fmf, Rb, Gll^Fmf, Gll^Fmf, Gll^Fmf, Ds, Ds, Wwt, Wwt, Wo, Wo, Wwt, Rb, Wwt, Wwt, Gll^Fmf, Gll^Fmf, Gg
Gg, Gg, Gll^Fmf, Gg, Gll^Fmf, Rb, Isa, Rb, Gll^Fmf, Gll^Fmf, Gll^Fmf, Gll^Fmf, Chr, Chr, Rrc, Chr, Rrc, Rrc, Rrc, Chr, Chr, Gll^Fmf, Rb, Gll^Fmf, Wwt, Rb, Rb, Wwt, Wwt, Wwt, Wwt, Wo, Wwt, Gg, Gll^Fp, Gg, Wwt, Gll^Fmf, Gll^Fmf, Gg
Rb, Gg, Gll^Fmf, Gll^Fmf, Gll^Fmf, Rb, Isa, Isa, Chr, Gll^Fmf, Chr, Chr, Rrc, Rrc, Chr, Chr, Chr, Rp^Vhcr, Rp^Vhcr, Gd^Fetd, Chr, Chr, Chr, Gll^Fmf, Gg, Wwt, Wwt, Wwt, Wwt, Wo, Wo, Rb, Gg, Wwt, Gll^Fp, Gll^Fp, Wwt, Gll^Fmf, Gll^Fmf, Gg
Gg, Gg, Gll^Fmf, Gll^Fmf, Gll^Fmf, Gll^Fmf, Isa, Isa, Isa, Chr, Chr, Rrc, Gg, Rp^Vhcr, Rp^Vhcr, Rp^Vhcr, Rp^Vhcr, Rrc, Chr, Isa, Isa, Chr, Chr, Rb, Wwt, Wwt, Wwt, Wo, Wo, Wo, Wwt, Wo, Wwt, Wwt, Ds, Gll^Fp, Gll^Fmf, Gll^Fp, Gll^Fmf, Gg
Gll^Fmf, Gg, Gll^Fmf, Gg, Gll^Fmf, Gll^Fmf, Chr, Isa, Isa, Rrc, Isa, Rp^Vhcr, Rp^Vhcr, Chr, Isa, Rp^Vhcr, Chr, Chr, Chr, Isa, Chr, Chr, Ds, Wwt, Wwt, Wo, Wo, Wo, Wo, Wwt, Wo, Wwt, Wwt, Wwt, Wwt, Ds, Gll^Fmf, Gll^Fmf, Gll^Fmf, Gg
Gg, Gll^Fmf, Gll^Fmf, Gll^Fmf, Gd^Fetd, Gll^Fmf, Chr, Gg, Rp^Vhcr, Isa, Isa, Isa, Isa, Chr, Isa, Isa, Rp^Vhcr, Isa, Rrc, Chr, Chr, Wwt, Wwt, Wwt, Wo, Wo, Wo, Wwt, Wwt, Wwt, Wwt, Gg, Gll^Fdf, Ds, Ds, Gll^Fdf, Gll^Fmf, Gll^Fmf, Gll^Fmf, Gg
Gll^Fmf, Gll^Fmf, Gll^Fmf, Gll^Fmf, Rb, Rb, Chr, Rp^Vhcr, Rp^Vhcr, Rp^Vhcr, Rp^Vhcr, Isa, Isa, Rp^Vhcr, Isa, Rp^Vhcr, Rp^Vhcr, Isa, Isa, Chr, Chr, Wwt, Wo, Wo, Wo, Wo, Wo, Wwt, Rb, Wwt, Rb, Gll^Fmf, Gll^Fmf, Gll^Fmf, Gll^Fdf, Gll^Fmf, Gll^Fdf, Gll^Fmf, Gll^Fmf, Gg
Gll^Fmf, Gll^Fmf, Rb, Chr, Chr, Chr, Chr, Rp^Vhcr, Chr, Gg, Rp^Vhcr, Rp^Vhcr, Wwt, Isa, Isa, Rp^Vhcr, Isa, Rp^Vhcr, Chr, Chr, Wwt, Wo, Wo, Wo, Wo, Wo, Wo, Wwt, Wwt, Chr, Chr, Chr, Chr, Chr, Chr, Chr, Chr, Gll^Fmf, Gll^Fmf, Gg
Gg, Gll^Fmf, Rb, Chr, Rp^Vhcr, Rp^Vhcr, Isa, Chr, Chr, Gd^Fetd, Rp^Vhcr, Isa, Rp^Vhcr, Isa, Rp, Isa, Isa, Rp^Vhcr, Rp, Wwt, Wo, Wo, Wo, Wo, Wwt, Wo, Rb, Wwt, Chr, Chr, Chr, Chr, Isa, Isa, Rrc, Chr, Chr, Gll^Fmf, Gll^Fmf, Gg
Gll^Fmf, Gll^Fmf, Rb, Chr, Rp^Vhcr, Isa, Isa, Isa, Isa, Rrc, Chr, Chr, Chr, Rp, Chr, Chr, Rp, Wwt^Bsb\, Wwt^Bsb\, Wo^Bsb\, Wo^Bsb\, Wo, Wwt, Wo, Gg, Wwt, Wwt, Ds, Isa, Isa, Gd^Fetd, Rp^Vhcr, Rp^Vhcr, Gd^Fetd, Isa, Rrc, Chr, Gll^Fmf, Gll^Fmf, Gg
Gg, Gll^Fmf, Gll^Fmf, Chr, Rrc, Rp^Vhcr, Rp^Vhcr, Rp^Vhcr, Rp^Vhcr, Rp^Vhcr, Chr, Chr, Rrc, Rb, Chr, Wwt, Wwt, Wo^Bsb\, Wo^Bsb\, Wo^Bsb\, Wo^Bsb\, Wwt^Bsb\, Wwt^Bsb\, Wwt, Wwt, Ds, Ds, Chr, Isa, Isa, Rp^Vhcr, Rp^Vhcr, Chr, Rp^Vhcr, Chr, Chr, Chr, Gll^Fmf, Gll^Fmf, Gg
Gg, Gll^Fmf, Gll^Fmf, Chr, Rrc, Rp^Vhcr, Isa, Chr, Rp^Vhcr, Rrc, Rrc, Rrc, Chr, Rrc, Chr, Wwt, Wo, Wo, Wo, Wo^Bsb\, Wo^Bsb\, Rp, Isa, Isa, Isa, Chr, Chr, Chr, Rp^Vhcr, Rp^Vhcr, Chr, Rp^Vhcr, Rp^Vhcr, Isa, Isa, Chr, Gll^Fmf, Gll^Fmf, Gll^Fmf, Gg
Gg, Gll^Fmf, Chr, Chr, Rp^Vhcr, Rp^Vhcr, Isa, Isa, Chr, Chr, Chr, Chr, Ds, Wwt, Ds, Wwt, Wo, Wo, Wo, Wo, Wwt, Isa, Isa, Gg, Isa, Isa, Isa, Rrc, Rrc, Rp^Vhcr, Chr, Isa, Chr, Rp^Vhcr, Chr, Chr, Gll^Fmf, Gll^Fmf, Gll^Fmf, Gg
Gg, Chr, Chr, Rrc, Gd^Fetd, Rp^Vhcr, Rrc, Rp^Vhcr, Ds, Wwt, Wwt, Wwt, Wwt, Wo, Wwt, Wo, Wo, Wo, Wwt, Rb, Chr, Chr, Rp^Vhcr, Rrc, Chr, Rp^Vhcr, Rp^Vhcr, Isa, Isa, Isa, Isa, Isa, Rp^Vhcr, Chr, Chr, Gll^Fmf, Gll^Fmf, Gll^Fmf, Gg, Gg
Gg, Chr, Chr, Rrc, Rp^Vhcr, Rp^Vhcr, Chr, Chr, Chr, Wwt, Wwt, Wo, Wo, Wo, Wo, Wo, Wo, Wwt, Wwt, Chr, Isa, Chr, Rp^Vhcr, Rp^Vhcr, Rp^Vhcr, Chr, Rp^Vhcr, Isa, Rp^Vhcr, Isa, Isa, Isa, Isa, Chr, Gll^Fmf, Gll^Fmf, Gll^Fmf, Gll^Fmf, Gll^Fmf, Gll^Fmf
Gg, Gg, Gll^Fmf, Chr, Chr, Chr, Chr, Wwt, Wwt, Wo, Wo, Wo, Wo, Wo, Wo, Wo, Wwt, Ds, Chr, Chr, Isa, Rp^Vhcr, Rrc, Rrc, Rp^Vhcr, Rp^Vhcr, Rrc, Chr, Rp^Vhcr, Isa, Rp^Vhcr, Isa, Isa, Isa, Gll^Fmf, Gll^Fmf, Gll^Fmf, Gll^Fmf, Gll^Fmf, Gll^Fmf
Gg, Gg, Gll^Fmf, Gll^Fmf, Rb, Wwt, Wwt, Wo, Wo, Wo, Wo, Wo, Wo, Wo, Wo, Wwt, Wwt, Ds, Chr, Gg, Rrc, Isa, Chr, Chr, Isa, Rp^Vhcr, Rrc, Chr, Rrc, Rrc, Rrc, Rp^Vhcr, Chr, Isa, Isa, Gll^Fmf, Gll^Fmf, Gll^Fmf, Gll^Fmf, Gll^Fmf
Gg, Gll^Fmf, Gll^Fmf, Gll^Fmf, Wwt, Wwt, Wo, Wo, Wo, Wo, Wo, Wwt, Wwt, Wwt, Wwt, Ds, Ds, Chr, Chr, Rrc, Rrc, Chr, Isa, Isa, Rp^Vhcr, Rp^Vhcr, Chr, Chr, Rrc, Chr, Chr, Chr, Gll^Fmf, Gg, Gg, Rb, Gll^Fmf, Gll^Fmf, Gg, Gll^Fmf
Gg, Gll^Fmf, Gll^Fmf, Gll^Fmf, Wwt, Wo, Wo, Wo, Wo, Wwt, Wwt, Gg, Ds, Rb, Gll^Fmf, Gll^Fmf, Gll^Fmf, Gll^Fmf, Chr, Chr, Chr, Chr, Chr, Isa, Chr, Isa, Chr, Rrc, Chr, Chr, Gll^Fmf, Gd^Fetd, Gll^Fmf, Gll^Fmf, Gg, Rb, Rb, Gg, Gg, Gll^Fmf
Gg, Gll^Fmf, Gll^Fmf, Wwt, Wo, Wo, Wo, Wo, Wo, Wwt, Gll^Fmf, Gg, Gll^Fmf, Gll^Fmf, Gll^Fmf, Gll^Fmf, Gll^Fmf, Gll^Fmf, Gll^Fmf, Gll^Fmf, Gll^Fmf, Gll^Fmf, Gll^Fmf, Chr, Isa, Chr, Chr, Rrc, Chr, Gll^Fmf, Gll^Fmf, Gll^Fmf, Gll^Fmf, Gll^Fmf, Gll^Fmf, Gg, Gg, Rb, Rb, Gg
Gg, Gg, Gg, Wwt, Wwt, Wwt, Wwt, Wwt, Wo, Gll^Fmf, Wwt, Gll^Fmf, Gg, Gg, Gg, Gg, Gg, Gll^Fmf, Gg, Gd^Fetd, Gg, Gll^Fmf, Gg, Gll^Fmf, Gg, Chr, Gg, Chr, Gg, Gll^Fmf, Gg, Gll^Fmf, Gll^Fmf, Gll^Fmf, Gll^Fmf, Gll^Fmf, Gg, Rb, Gg, Gg
